Season,Label,TeamOneID,TeamTwoID,TeamOneSeed,TeamTwoSeed,SeedDiff
1985,1,1116,1234,9,8,1
1985,0,1116,1385,9,1,8
1985,1,1207,1385,1,1,0
1985,0,1246,1385,12,1,11
1985,0,1380,1385,16,1,15
1985,0,1301,1385,3,1,2
1985,1,1120,1345,11,6,5
1985,1,1120,1242,11,3,8
1985,0,1120,1314,11,2,9
1985,0,1292,1314,15,2,13
1985,1,1207,1250,1,16,-15
1985,1,1207,1396,1,8,-7
1985,1,1207,1260,1,4,-3
1985,0,1233,1260,13,4,9
1985,1,1207,1210,1,2,-1
1985,0,1207,1437,1,8,-7
1985,0,1268,1437,5,8,-3
1985,0,1272,1437,2,8,-6
1985,0,1173,1437,9,8,1
1985,0,1314,1437,2,8,-6
1985,0,1276,1437,1,8,-7
1985,1,1229,1425,9,8,1
1985,0,1229,1328,9,1,8
1985,0,1256,1328,5,1,4
1985,0,1299,1328,16,1,15
1985,1,1272,1328,2,1,1
1985,1,1242,1325,3,14,-11
1985,1,1246,1449,12,5,7
1985,1,1246,1424,12,4,8
1985,0,1361,1424,13,4,9
1985,1,1256,1338,5,12,-7
1985,1,1256,1326,5,4,1
1985,0,1235,1326,13,4,9
1985,1,1323,1333,7,10,-3
1985,0,1330,1374,12,5,7
1985,1,1260,1374,4,5,-1
1985,1,1396,1439,8,9,-1
1985,1,1104,1112,7,10,-3
1985,1,1104,1433,7,2,5
1985,0,1267,1433,15,2,13
1985,0,1104,1301,7,3,4
1985,1,1130,1403,11,6,5
1985,1,1130,1181,11,3,8
1985,0,1130,1272,11,2,9
1985,1,1181,1337,3,14,-11
1985,1,1208,1455,6,11,-5
1985,0,1208,1228,6,3,3
1985,1,1210,1228,2,3,-1
1985,1,1210,1273,2,15,-13
1985,1,1210,1393,2,7,-5
1985,0,1177,1393,10,7,3
1985,1,1228,1318,3,14,-11
1985,1,1268,1275,5,12,-7
1985,1,1268,1298,5,13,-8
1985,0,1261,1298,4,13,-9
1985,1,1272,1335,2,15,-13
1985,1,1272,1412,2,7,-5
1985,0,1277,1412,10,7,3
1985,0,1192,1276,16,1,15
1985,1,1301,1305,3,14,-11
1985,1,1301,1431,3,11,-8
1985,0,1409,1431,6,11,-5
1985,1,1314,1323,2,7,-5
1986,1,1133,1431,7,10,-3
1986,0,1133,1257,7,2,5
1986,0,1181,1257,1,2,-1
1986,0,1180,1257,15,2,13
1986,0,1120,1257,8,2,6
1986,1,1177,1438,12,5,7
1986,1,1177,1328,12,4,8
1986,0,1318,1328,13,4,9
1986,0,1177,1181,12,1,11
1986,1,1181,1290,1,16,-15
1986,1,1181,1330,1,8,-7
1986,1,1181,1298,1,7,-6
1986,0,1156,1298,14,7,7
1986,1,1181,1242,1,1,0
1986,1,1207,1403,4,13,-9
1986,0,1207,1277,4,5,-1
1986,1,1242,1277,1,5,-4
1986,1,1210,1265,2,15,-13
1986,1,1210,1437,2,10,-8
1986,0,1210,1261,2,11,-9
1986,0,1246,1261,1,11,-10
1986,1,1257,1261,2,11,-9
1986,1,1242,1299,1,16,-15
1986,1,1242,1396,1,9,-8
1986,0,1239,1396,8,9,-1
1986,1,1242,1301,1,6,-5
1986,0,1114,1301,14,6,8
1986,0,1235,1301,7,6,1
1986,0,1234,1301,11,6,5
1986,1,1261,1345,11,6,5
1986,1,1261,1272,11,3,8
1986,0,1123,1272,14,3,11
1986,1,1277,1449,5,12,-7
1986,1,1314,1428,3,14,-11
1986,1,1314,1412,3,6,-3
1986,0,1281,1412,11,6,5
1986,1,1330,1452,8,9,-1
1986,1,1437,1439,10,7,3
1986,1,1104,1462,5,12,-7
1986,1,1104,1228,5,4,1
1986,0,1193,1228,13,4,9
1986,0,1104,1246,5,1,4
1986,0,1172,1246,16,1,15
1986,1,1114,1323,14,3,11
1986,0,1112,1120,9,8,1
1986,1,1156,1231,14,3,11
1986,1,1156,1386,14,6,8
1986,0,1350,1386,11,6,5
1986,1,1235,1275,7,10,-3
1986,1,1235,1276,7,2,5
1986,0,1103,1276,15,2,13
1986,1,1268,1337,5,12,-7
1986,0,1268,1424,5,4,1
1986,0,1419,1424,13,4,9
1986,1,1120,1424,8,4,4
1986,1,1298,1409,7,10,-3
1986,1,1298,1393,7,2,5
1986,0,1135,1393,15,2,13
1986,0,1286,1385,16,1,15
1986,1,1120,1385,8,1,7
1986,0,1304,1443,9,8,1
1986,1,1246,1443,1,8,-7
1986,1,1257,1314,2,3,-1
1987,1,1104,1299,2,15,-13
1987,1,1104,1309,2,7,-5
1987,0,1140,1309,10,7,3
1987,0,1104,1344,2,6,-4
1987,0,1122,1344,14,6,8
1987,0,1207,1344,1,6,-5
1987,1,1120,1360,8,9,-1
1987,0,1120,1231,8,1,7
1987,0,1181,1231,5,1,4
1987,0,1193,1231,16,1,15
1987,1,1122,1228,14,3,11
1987,1,1181,1401,5,12,-7
1987,1,1181,1462,5,13,-8
1987,0,1281,1462,4,13,-9
1987,0,1208,1243,8,9,-1
1987,1,1276,1298,9,8,1
1987,0,1276,1314,9,1,8
1987,1,1314,1335,1,16,-15
1987,1,1314,1323,1,5,-4
1987,0,1292,1323,12,5,7
1987,0,1314,1393,1,2,-1
1987,0,1344,1393,6,2,4
1987,0,1196,1393,6,2,4
1987,0,1204,1393,15,2,13
1987,1,1231,1393,1,2,-1
1987,1,1344,1412,6,11,-5
1987,0,1267,1395,13,4,9
1987,1,1323,1395,5,4,1
1987,0,1141,1417,13,4,9
1987,0,1226,1424,16,1,15
1987,0,1234,1424,2,1,1
1987,0,1243,1424,9,1,8
1987,1,1231,1424,1,1,0
1987,0,1438,1461,5,12,-7
1987,0,1417,1461,4,12,-8
1987,1,1424,1461,1,12,-11
1987,1,1177,1256,3,14,-11
1987,1,1177,1385,3,6,-3
1987,0,1177,1261,3,10,-7
1987,0,1210,1261,7,10,-3
1987,1,1231,1261,1,10,-9
1987,1,1196,1301,6,11,-5
1987,1,1196,1345,6,3,3
1987,0,1318,1345,14,3,11
1987,0,1137,1207,16,1,15
1987,1,1234,1365,2,15,-13
1987,1,1234,1431,2,7,-5
1987,0,1112,1431,10,7,3
1987,1,1234,1328,2,6,-4
1987,0,1222,1242,12,5,7
1987,1,1207,1242,1,5,-4
1987,0,1155,1283,4,13,-9
1987,1,1242,1283,5,13,-8
1987,0,1246,1326,8,9,-1
1987,1,1207,1326,1,9,-8
1987,1,1328,1409,6,11,-5
1987,1,1328,1338,6,3,3
1987,0,1265,1338,14,3,11
1987,1,1385,1455,6,11,-5
1987,0,1380,1396,15,2,13
1987,1,1261,1396,10,2,8
1987,1,1443,1452,10,7,3
1987,1,1393,1443,2,10,-8
1988,1,1120,1133,8,9,-1
1988,0,1120,1328,8,1,7
1988,0,1257,1328,5,1,4
1988,0,1151,1328,16,1,15
1988,0,1112,1328,1,1,0
1988,1,1242,1328,6,1,5
1988,1,1140,1150,4,13,-9
1988,0,1140,1257,4,5,-1
1988,1,1177,1455,5,12,-7
1988,0,1177,1243,5,4,1
1988,1,1242,1243,6,4,2
1988,0,1131,1181,15,2,13
1988,1,1196,1385,6,11,-5
1988,0,1196,1276,6,3,3
1988,0,1129,1276,14,3,11
1988,1,1243,1247,4,13,-9
1988,1,1243,1345,4,1,3
1988,0,1192,1345,16,1,15
1988,0,1272,1345,9,1,8
1988,1,1257,1333,5,12,-7
1988,1,1258,1461,10,7,3
1988,0,1258,1314,10,2,8
1988,1,1112,1314,1,2,-1
1988,0,1276,1314,3,2,1
1988,0,1124,1272,8,9,-1
1988,1,1314,1317,2,15,-13
1988,0,1281,1348,6,11,-5
1988,1,1181,1348,2,11,-9
1988,0,1323,1374,10,7,3
1988,1,1181,1374,2,7,-5
1988,0,1299,1393,14,3,11
1988,1,1348,1393,11,3,8
1988,1,1112,1165,1,16,-15
1988,1,1112,1371,1,8,-7
1988,1,1112,1234,1,5,-4
1988,0,1199,1234,12,5,7
1988,1,1207,1261,8,9,-1
1988,0,1207,1396,8,1,7
1988,0,1250,1396,16,1,15
1988,1,1181,1396,2,1,1
1988,0,1350,1396,13,1,12
1988,1,1210,1235,5,12,-7
1988,0,1210,1350,5,13,-8
1988,0,1231,1350,4,13,-9
1988,1,1228,1427,3,14,-11
1988,0,1228,1437,3,6,-3
1988,0,1246,1437,2,6,-4
1988,0,1116,1437,11,6,5
1988,1,1328,1437,1,6,-5
1988,1,1242,1462,6,11,-5
1988,1,1242,1293,6,14,-8
1988,1,1242,1435,6,7,-1
1988,0,1429,1435,10,7,3
1988,0,1338,1435,2,7,-5
1988,1,1246,1380,2,15,-13
1988,1,1246,1268,2,7,-5
1988,1,1268,1364,7,10,-3
1988,1,1293,1301,14,3,11
1988,0,1185,1338,15,2,13
1988,1,1371,1431,8,9,-1
1988,0,1283,1424,13,4,9
1988,1,1234,1424,5,4,1
1988,0,1181,1242,2,6,-4
1989,1,1112,1352,1,16,-15
1989,1,1112,1155,1,9,-8
1989,0,1112,1424,1,4,-3
1989,0,1177,1424,12,4,8
1989,0,1225,1424,13,4,9
1989,1,1371,1424,3,4,-1
1989,1,1116,1258,5,12,-7
1989,0,1116,1257,5,4,1
1989,1,1228,1257,1,4,-3
1989,0,1114,1257,13,4,9
1989,1,1123,1338,9,8,1
1989,0,1123,1228,9,1,8
1989,1,1155,1388,9,8,1
1989,1,1177,1272,12,5,7
1989,1,1181,1354,2,15,-13
1989,1,1181,1452,2,7,-5
1989,0,1397,1452,10,7,3
1989,1,1181,1278,2,11,-9
1989,0,1243,1278,6,11,-5
1989,1,1181,1207,2,1,1
1989,0,1181,1371,2,3,-1
1989,0,1191,1371,11,3,8
1989,1,1276,1371,3,3,0
1989,0,1283,1371,14,3,11
1989,0,1231,1371,2,3,-1
1989,1,1228,1270,1,16,-15
1989,1,1228,1393,1,2,-1
1989,0,1161,1393,10,2,8
1989,0,1137,1393,15,2,13
1989,0,1281,1393,3,2,1
1989,0,1228,1276,1,3,-2
1989,0,1247,1256,8,9,-1
1989,0,1199,1292,4,13,-9
1989,0,1190,1328,16,1,15
1989,0,1256,1328,9,1,8
1989,1,1373,1390,14,3,11
1989,0,1344,1438,12,5,7
1989,1,1276,1438,3,5,-2
1989,0,1292,1438,13,5,8
1989,0,1328,1438,1,5,-4
1989,1,1161,1196,10,7,3
1989,1,1191,1333,11,6,5
1989,1,1207,1343,1,16,-15
1989,1,1207,1323,1,9,-8
1989,1,1207,1301,1,5,-4
1989,0,1234,1301,4,5,-1
1989,0,1206,1231,15,2,13
1989,1,1234,1353,4,13,-9
1989,1,1276,1462,3,14,-11
1989,1,1276,1375,3,11,-8
1989,0,1104,1375,6,11,-5
1989,1,1276,1314,3,2,1
1989,0,1166,1281,14,3,11
1989,1,1301,1376,5,12,-7
1989,1,1314,1380,2,15,-13
1989,1,1314,1417,2,7,-5
1989,0,1235,1417,10,7,3
1989,1,1323,1435,9,8,1
1989,0,1210,1400,6,11,-5
1989,1,1281,1400,3,11,-8
1989,0,1261,1431,10,7,3
1989,1,1231,1431,2,7,-5
1989,1,1278,1373,11,14,-3
1990,1,1116,1343,4,13,-9
1990,1,1116,1173,4,12,-8
1990,1,1116,1314,4,8,-4
1990,0,1283,1314,9,8,1
1990,1,1116,1400,4,10,-6
1990,0,1345,1400,2,10,-8
1990,0,1208,1400,7,10,-3
1990,0,1116,1181,4,3,1
1990,0,1163,1181,1,3,-2
1990,1,1123,1333,12,5,7
1990,1,1123,1257,12,4,8
1990,0,1225,1257,13,4,9
1990,0,1123,1424,12,1,11
1990,0,1326,1424,8,1,7
1990,0,1114,1424,16,1,15
1990,0,1181,1424,3,1,2
1990,0,1258,1424,11,1,10
1990,0,1210,1424,4,1,3
1990,1,1143,1231,9,8,1
1990,0,1143,1163,9,1,8
1990,0,1131,1163,16,1,15
1990,0,1155,1163,5,1,4
1990,0,1140,1155,12,5,7
1990,1,1173,1228,12,5,7
1990,0,1190,1210,13,4,9
1990,1,1247,1379,4,13,-9
1990,1,1261,1437,5,12,-7
1990,1,1277,1293,1,16,-15
1990,1,1277,1364,1,9,-8
1990,0,1222,1364,8,9,-1
1990,1,1326,1344,8,9,-1
1990,1,1328,1406,1,16,-15
1990,1,1104,1161,7,10,-3
1990,1,1104,1112,7,2,5
1990,0,1104,1258,7,11,-4
1990,1,1112,1378,2,15,-13
1990,1,1181,1350,3,14,-11
1990,1,1181,1385,3,6,-3
1990,1,1181,1417,3,7,-4
1990,0,1242,1417,2,7,-5
1990,0,1412,1417,10,7,3
1990,1,1207,1411,3,14,-11
1990,0,1207,1462,3,6,-3
1990,0,1243,1462,11,6,5
1990,1,1400,1462,10,6,4
1990,1,1242,1352,2,15,-13
1990,1,1258,1308,11,6,5
1990,1,1258,1276,11,3,8
1990,0,1229,1276,14,3,11
1990,1,1278,1431,6,11,-5
1990,1,1278,1320,6,14,-8
1990,0,1281,1320,3,14,-11
1990,1,1278,1393,6,2,4
1990,0,1164,1393,15,2,13
1990,1,1345,1419,2,15,-13
1990,1,1385,1396,6,11,-5
1990,0,1323,1438,10,7,3
1990,1,1393,1438,2,7,-5
1990,1,1155,1247,5,4,1
1990,1,1210,1261,4,5,-1
1990,1,1210,1277,4,1,3
1990,1,1210,1278,4,6,-2
1990,1,1314,1328,8,1,7
1991,1,1112,1384,2,15,-13
1991,1,1112,1140,2,10,-8
1991,0,1112,1371,2,3,-1
1991,0,1166,1371,11,3,8
1991,0,1337,1371,14,3,11
1991,1,1140,1438,10,7,3
1991,1,1163,1261,11,6,5
1991,1,1163,1462,11,14,-3
1991,0,1304,1462,3,14,-11
1991,0,1163,1181,11,2,9
1991,1,1166,1308,11,6,5
1991,1,1181,1419,2,15,-13
1991,1,1181,1234,2,7,-5
1991,0,1190,1234,10,7,3
1991,1,1181,1385,2,4,-2
1991,0,1326,1385,1,4,-3
1991,0,1296,1385,13,4,9
1991,1,1181,1424,2,1,1
1991,0,1207,1424,8,1,7
1991,0,1285,1424,16,1,15
1991,0,1371,1424,3,1,2
1991,1,1181,1242,2,3,-1
1991,0,1116,1242,1,3,-2
1991,0,1231,1242,2,3,-1
1991,1,1199,1425,7,10,-3
1991,0,1199,1231,7,2,5
1991,0,1157,1231,15,2,13
1991,1,1242,1309,3,14,-11
1991,1,1242,1338,3,6,-3
1991,0,1208,1338,11,6,5
1991,1,1242,1314,3,1,2
1991,0,1185,1314,12,1,11
1991,1,1301,1379,6,11,-5
1991,0,1301,1329,6,3,3
1991,0,1307,1329,14,3,11
1991,1,1350,1393,15,2,13
1991,0,1350,1396,15,10,5
1991,0,1345,1396,7,10,-3
1991,1,1314,1396,1,10,-9
1991,0,1329,1396,3,10,-7
1991,1,1104,1293,4,13,-9
1991,1,1104,1448,4,5,-1
1991,0,1256,1448,12,5,7
1991,0,1104,1116,4,1,3
1991,0,1113,1116,8,1,7
1991,1,1113,1353,8,9,-1
1991,1,1116,1209,1,16,-15
1991,1,1185,1280,12,5,7
1991,1,1185,1336,12,13,-1
1991,1,1207,1435,8,9,-1
1991,0,1177,1210,9,8,1
1991,1,1277,1453,5,12,-7
1991,0,1277,1428,5,4,1
1991,0,1375,1428,13,4,9
1991,1,1424,1428,1,4,-3
1991,1,1314,1318,1,16,-15
1991,1,1314,1437,1,9,-8
1991,0,1343,1437,8,9,-1
1991,1,1326,1406,1,16,-15
1991,1,1336,1417,13,4,9
1991,0,1389,1400,12,5,7
1991,1,1385,1400,4,5,-1
1991,0,1210,1326,8,1,7
1992,1,1104,1390,5,12,-7
1992,0,1104,1314,5,4,1
1992,0,1275,1314,13,4,9
1992,1,1116,1293,3,14,-11
1992,0,1116,1272,3,6,-3
1992,0,1210,1272,7,6,1
1992,1,1153,1272,4,6,-2
1992,1,1163,1304,9,8,1
1992,0,1163,1326,9,1,8
1992,0,1290,1326,16,1,15
1992,1,1276,1326,6,1,5
1992,0,1314,1326,4,1,3
1992,0,1144,1181,16,1,15
1992,1,1199,1285,3,14,-11
1992,1,1199,1207,3,6,-3
1992,0,1199,1231,3,2,1
1992,0,1183,1231,15,2,13
1992,1,1181,1231,1,2,-1
1992,1,1207,1378,6,11,-5
1992,1,1210,1222,7,10,-3
1992,1,1210,1425,7,2,5
1992,0,1419,1425,15,2,13
1992,1,1234,1400,9,8,1
1992,0,1140,1261,10,7,3
1992,1,1231,1261,2,7,-5
1992,1,1272,1337,6,11,-5
1992,1,1281,1452,5,12,-7
1992,0,1281,1371,5,4,1
1992,0,1247,1371,13,4,9
1992,1,1181,1371,1,4,-3
1992,1,1153,1174,4,13,-9
1992,1,1153,1277,4,5,-1
1992,1,1153,1431,4,9,-5
1992,0,1191,1431,8,9,-1
1992,0,1242,1431,1,9,-8
1992,0,1153,1276,4,6,-2
1992,1,1181,1276,1,6,-5
1992,0,1190,1276,14,6,8
1992,0,1112,1190,3,14,-11
1992,0,1150,1235,7,10,-3
1992,0,1224,1242,16,1,15
1992,1,1246,1330,2,15,-13
1992,1,1246,1269,2,3,-1
1992,0,1200,1269,14,3,11
1992,1,1257,1448,8,9,-1
1992,0,1257,1417,8,1,7
1992,0,1352,1417,16,1,15
1992,1,1231,1417,2,1,1
1992,0,1308,1417,12,1,11
1992,1,1276,1396,6,11,-5
1992,1,1276,1329,6,2,4
1992,0,1204,1329,15,2,13
1992,1,1277,1283,5,12,-7
1992,0,1177,1308,5,12,-7
1992,0,1343,1393,11,6,5
1992,1,1269,1393,3,6,-3
1992,0,1385,1408,7,10,-3
1992,1,1329,1408,2,10,-8
1992,0,1328,1418,4,13,-9
1992,1,1308,1418,12,13,-1
1992,1,1181,1234,1,9,-8
1992,1,1181,1246,1,2,-1
1992,0,1235,1246,10,2,8
1993,1,1116,1221,4,13,-9
1993,1,1116,1385,4,5,-1
1993,0,1116,1314,4,1,3
1993,0,1187,1314,16,1,15
1993,0,1153,1314,2,1,1
1993,0,1276,1314,1,1,0
1993,0,1242,1314,2,1,1
1993,1,1140,1374,7,10,-3
1993,0,1140,1242,7,2,5
1993,0,1143,1242,6,2,4
1993,0,1123,1242,15,2,13
1993,0,1231,1242,1,2,-1
1993,1,1143,1261,6,11,-5
1993,1,1143,1181,6,3,3
1993,1,1181,1356,3,14,-11
1993,0,1191,1199,14,3,11
1993,1,1228,1253,6,11,-5
1993,0,1228,1435,6,3,3
1993,0,1129,1435,14,3,11
1993,1,1396,1435,7,3,4
1993,0,1345,1348,9,8,1
1993,1,1314,1348,1,8,-7
1993,0,1112,1365,2,15,-13
1993,1,1371,1398,2,15,-13
1993,0,1371,1443,2,7,-5
1993,0,1272,1443,10,7,3
1993,1,1199,1443,3,7,-4
1993,1,1385,1403,5,12,-7
1993,0,1281,1396,10,7,3
1993,0,1365,1396,15,7,8
1993,1,1276,1396,1,7,-6
1993,0,1243,1408,6,11,-5
1993,1,1199,1408,3,11,-8
1993,1,1153,1164,2,15,-13
1993,1,1153,1308,2,7,-5
1993,0,1304,1308,10,7,3
1993,1,1153,1438,2,6,-4
1993,0,1269,1438,3,6,-3
1993,0,1264,1438,11,6,5
1993,1,1203,1307,12,5,7
1993,1,1203,1380,12,13,-1
1993,0,1210,1380,4,13,-9
1993,0,1203,1276,12,1,11
1993,0,1246,1276,1,1,0
1993,0,1157,1276,16,1,15
1993,1,1231,1460,1,16,-15
1993,1,1231,1462,1,9,-8
1993,0,1309,1462,8,9,-1
1993,1,1231,1257,1,4,-3
1993,0,1174,1257,13,4,9
1993,1,1234,1419,4,13,-9
1993,0,1234,1448,4,5,-1
1993,1,1246,1448,1,5,-4
1993,0,1151,1448,12,5,7
1993,1,1246,1351,1,16,-15
1993,1,1246,1428,1,8,-7
1993,0,1338,1428,9,8,1
1993,1,1269,1335,3,14,-11
1993,0,1266,1329,12,5,7
1993,1,1257,1329,4,5,-1
1993,0,1235,1417,8,9,-1
1993,1,1276,1417,1,9,-8
1993,0,1199,1246,3,1,2
1994,1,1104,1344,9,8,1
1994,0,1104,1345,9,1,8
1994,1,1181,1345,2,1,1
1994,0,1242,1345,4,1,3
1994,1,1163,1351,2,15,-13
1994,1,1163,1203,2,10,-8
1994,0,1163,1196,2,3,-1
1994,0,1130,1196,9,3,6
1994,1,1181,1196,2,3,-1
1994,1,1196,1241,3,14,-11
1994,1,1196,1335,3,11,-8
1994,0,1304,1335,6,11,-5
1994,1,1203,1412,10,7,3
1994,0,1151,1242,13,4,9
1994,1,1268,1387,10,7,3
1994,1,1268,1269,10,2,8
1994,0,1268,1276,10,3,7
1994,1,1116,1276,1,3,-2
1994,1,1269,1402,2,15,-13
1994,1,1276,1337,3,14,-11
1994,1,1276,1400,3,6,-3
1994,1,1281,1298,1,16,-15
1994,1,1281,1458,1,9,-8
1994,0,1153,1458,8,9,-1
1994,1,1281,1393,1,4,-3
1994,0,1218,1393,13,4,9
1994,1,1345,1416,1,16,-15
1994,1,1400,1443,6,11,-5
1994,0,1158,1448,12,5,7
1994,1,1242,1448,4,5,-1
1994,0,1143,1453,5,12,-7
1994,1,1393,1453,4,12,-8
1994,1,1112,1259,2,15,-13
1994,1,1112,1438,2,7,-5
1994,0,1307,1438,10,7,3
1994,1,1112,1257,2,3,-1
1994,0,1129,1257,14,3,11
1994,1,1112,1281,2,1,1
1994,0,1112,1116,2,1,1
1994,1,1116,1299,1,16,-15
1994,1,1116,1207,1,9,-8
1994,1,1116,1409,1,12,-11
1994,0,1329,1409,4,12,-8
1994,1,1116,1181,1,2,-1
1994,1,1130,1450,9,8,1
1994,1,1130,1314,9,1,8
1994,0,1251,1314,16,1,15
1994,1,1130,1231,9,5,4
1994,1,1181,1411,2,15,-13
1994,1,1181,1277,2,7,-5
1994,1,1181,1266,2,6,-4
1994,0,1246,1266,3,6,-3
1994,1,1207,1228,9,8,1
1994,1,1231,1325,5,12,-7
1994,1,1231,1396,5,4,1
1994,0,1180,1396,13,4,9
1994,1,1246,1398,3,14,-11
1994,1,1266,1418,6,11,-5
1994,1,1277,1371,7,10,-3
1994,1,1278,1356,6,11,-5
1994,0,1308,1329,13,4,9
1994,1,1409,1417,12,5,7
1994,1,1257,1278,3,6,-3
1995,1,1104,1335,5,12,-7
1995,0,1104,1329,5,4,1
1995,0,1180,1329,13,4,9
1995,0,1269,1329,2,4,-2
1995,1,1113,1123,5,12,-7
1995,1,1113,1264,5,13,-8
1995,0,1113,1246,5,1,4
1995,1,1153,1396,7,10,-3
1995,0,1153,1163,7,2,5
1995,0,1151,1163,15,2,13
1995,0,1159,1242,16,1,15
1995,1,1246,1291,1,16,-15
1995,1,1246,1408,1,9,-8
1995,0,1140,1408,8,9,-1
1995,0,1246,1314,1,2,-1
1995,1,1116,1314,2,2,0
1995,0,1207,1314,6,2,4
1995,0,1293,1314,15,2,13
1995,0,1235,1314,7,2,5
1995,1,1264,1328,13,4,9
1995,0,1211,1268,14,3,11
1995,1,1163,1268,2,3,-1
1995,0,1112,1275,5,12,-7
1995,0,1278,1387,8,9,-1
1995,0,1332,1400,6,11,-5
1995,1,1268,1400,3,11,-8
1995,0,1311,1438,13,4,9
1995,1,1116,1438,2,4,-2
1995,0,1242,1438,1,4,-3
1995,0,1275,1438,12,4,8
1995,0,1276,1443,9,8,1
1995,1,1242,1443,1,8,-7
1995,0,1299,1448,16,1,15
1995,0,1387,1448,9,1,8
1995,1,1329,1448,4,1,3
1995,1,1116,1411,2,15,-13
1995,1,1116,1393,2,7,-5
1995,0,1356,1393,10,7,3
1995,1,1116,1272,2,6,-4
1995,0,1257,1272,11,6,5
1995,0,1116,1417,2,1,1
1995,0,1280,1417,5,1,4
1995,0,1198,1417,16,1,15
1995,0,1281,1417,8,1,7
1995,0,1163,1417,2,1,1
1995,0,1329,1417,4,1,3
1995,1,1207,1462,6,11,-5
1995,1,1207,1451,6,14,-8
1995,0,1277,1451,3,14,-11
1995,0,1196,1235,10,7,3
1995,1,1269,1389,2,15,-13
1995,1,1269,1390,2,10,-8
1995,0,1150,1390,7,10,-3
1995,1,1269,1409,2,6,-4
1995,0,1330,1409,14,6,8
1995,0,1228,1409,11,6,5
1995,1,1280,1365,5,12,-7
1995,1,1280,1428,5,4,1
1995,0,1253,1428,13,4,9
1995,0,1231,1281,9,8,1
1995,1,1330,1437,14,3,11
1995,1,1345,1453,3,14,-11
1995,1,1272,1345,6,3,3
1996,1,1116,1336,12,5,7
1996,1,1116,1266,12,4,8
1996,0,1116,1269,12,1,11
1996,1,1246,1269,1,1,0
1996,0,1207,1269,2,1,1
1996,0,1159,1163,16,1,15
1996,1,1180,1272,12,5,7
1996,0,1180,1393,12,4,8
1996,1,1246,1393,1,4,-3
1996,0,1280,1393,5,4,1
1996,0,1286,1393,13,4,9
1996,0,1242,1393,2,4,-2
1996,0,1208,1393,8,4,4
1996,0,1181,1185,8,9,-1
1996,1,1163,1185,1,9,-8
1996,0,1155,1208,9,8,1
1996,0,1143,1235,12,5,7
1996,1,1246,1363,1,16,-15
1996,1,1246,1439,1,9,-8
1996,1,1246,1428,1,4,-3
1996,0,1145,1428,13,4,9
1996,0,1235,1428,5,4,1
1996,1,1246,1448,1,2,-1
1996,0,1257,1448,6,2,4
1996,0,1419,1448,15,2,13
1996,0,1400,1448,10,2,8
1996,1,1266,1284,4,13,-9
1996,1,1269,1416,1,16,-15
1996,1,1269,1390,1,9,-8
1996,0,1133,1390,8,9,-1
1996,1,1280,1433,5,12,-7
1996,1,1280,1343,5,13,-8
1996,1,1343,1417,13,4,9
1996,1,1345,1441,1,16,-15
1996,1,1439,1453,9,8,1
1996,1,1112,1434,3,14,-11
1996,1,1112,1234,3,6,-3
1996,0,1203,1234,11,6,5
1996,0,1112,1242,3,2,1
1996,1,1130,1231,11,6,5
1996,0,1130,1210,11,3,8
1996,1,1153,1210,2,3,-1
1996,0,1122,1210,14,3,11
1996,1,1153,1422,2,15,-13
1996,1,1153,1396,2,7,-5
1996,0,1328,1396,10,7,3
1996,0,1153,1280,2,5,-3
1996,0,1163,1280,1,5,-4
1996,1,1207,1290,2,15,-13
1996,1,1207,1307,2,7,-5
1996,0,1243,1307,10,7,3
1996,1,1207,1403,2,3,-1
1996,0,1296,1403,14,3,11
1996,0,1314,1403,6,3,3
1996,1,1242,1354,2,15,-13
1996,1,1242,1365,2,10,-8
1996,0,1268,1365,7,10,-3
1996,1,1257,1409,6,11,-5
1996,1,1257,1437,6,3,3
1996,0,1339,1437,14,3,11
1996,0,1309,1314,11,6,5
1996,0,1276,1400,7,10,-3
1996,1,1208,1345,8,1,7
1997,1,1112,1375,4,13,-9
1997,1,1112,1158,4,12,-8
1997,1,1112,1242,4,1,3
1997,0,1238,1242,16,1,15
1997,1,1112,1344,4,10,-6
1997,0,1151,1344,14,10,4
1997,0,1181,1344,2,10,-8
1997,0,1266,1344,7,10,-3
1997,1,1112,1314,4,1,3
1997,0,1143,1314,5,1,4
1997,0,1160,1314,9,1,8
1997,0,1193,1314,16,1,15
1997,0,1257,1314,6,1,5
1997,1,1112,1246,4,1,3
1997,0,1234,1246,8,1,7
1997,1,1130,1434,5,12,-7
1997,0,1130,1386,5,4,1
1997,1,1246,1386,1,4,-3
1997,0,1334,1386,13,4,9
1997,1,1143,1343,5,12,-7
1997,1,1143,1437,5,4,1
1997,0,1254,1437,13,4,9
1997,0,1139,1153,14,3,11
1997,1,1158,1268,12,5,7
1997,1,1160,1231,9,8,1
1997,1,1234,1438,8,9,-1
1997,0,1229,1235,11,6,5
1997,0,1153,1235,3,6,-3
1997,1,1246,1285,1,16,-15
1997,1,1246,1428,1,2,-1
1997,0,1150,1428,7,2,5
1997,0,1298,1428,15,2,13
1997,0,1390,1428,6,2,4
1997,1,1246,1278,1,1,0
1997,0,1155,1278,4,1,3
1997,1,1345,1348,8,9,-1
1997,0,1149,1417,15,2,13
1997,1,1278,1417,1,2,-1
1997,0,1235,1417,6,2,4
1997,0,1435,1462,10,7,3
1997,1,1417,1462,2,7,-5
1997,1,1150,1207,7,10,-3
1997,1,1151,1208,14,3,11
1997,1,1151,1228,14,6,8
1997,1,1155,1275,4,13,-9
1997,1,1155,1409,4,5,-1
1997,0,1131,1409,12,5,7
1997,1,1164,1376,15,2,13
1997,0,1164,1400,15,10,5
1997,1,1257,1400,6,10,-4
1997,1,1181,1293,2,15,-13
1997,1,1228,1425,6,11,-5
1997,1,1257,1269,6,11,-5
1997,1,1257,1307,6,3,3
1997,1,1278,1402,1,16,-15
1997,1,1278,1396,1,9,-8
1997,0,1279,1396,8,9,-1
1997,1,1307,1330,3,14,-11
1997,0,1328,1390,11,6,5
1997,1,1400,1458,10,7,3
1997,0,1388,1448,14,3,11
1997,1,1390,1448,6,3,3
1997,1,1242,1345,1,8,-7
1998,1,1112,1311,1,16,-15
1998,1,1112,1229,1,9,-8
1998,1,1112,1268,1,4,-3
1998,0,1228,1268,5,4,1
1998,0,1112,1428,1,3,-2
1998,0,1116,1428,6,3,3
1998,0,1362,1428,14,3,11
1998,1,1246,1428,2,3,-1
1998,0,1314,1428,1,3,-2
1998,1,1116,1304,6,11,-5
1998,1,1150,1227,8,9,-1
1998,0,1150,1314,8,1,7
1998,0,1163,1314,2,1,1
1998,0,1298,1314,16,1,15
1998,0,1277,1314,4,1,3
1998,1,1153,1319,2,15,-13
1998,0,1153,1452,2,10,-8
1998,0,1396,1452,7,10,-3
1998,1,1428,1452,3,10,-7
1998,1,1163,1192,2,15,-13
1998,1,1163,1231,2,7,-5
1998,1,1163,1449,2,11,-9
1998,0,1350,1449,14,11,3
1998,1,1228,1375,5,12,-7
1998,1,1229,1397,9,8,1
1998,1,1231,1328,7,10,-3
1998,1,1268,1429,4,13,-9
1998,0,1185,1277,13,4,9
1998,1,1343,1424,5,12,-7
1998,1,1350,1376,14,3,11
1998,1,1449,1462,11,6,5
1998,1,1178,1385,10,7,3
1998,0,1178,1345,10,2,8
1998,0,1174,1345,15,2,13
1998,1,1181,1347,1,16,-15
1998,1,1181,1329,1,8,-7
1998,0,1203,1329,9,8,1
1998,1,1181,1393,1,5,-4
1998,0,1233,1393,12,5,7
1998,0,1307,1393,4,5,-1
1998,0,1181,1246,1,2,-1
1998,1,1199,1395,12,5,7
1998,0,1199,1434,12,13,-1
1998,0,1279,1434,4,13,-9
1998,1,1348,1434,8,13,-5
1998,1,1242,1341,1,16,-15
1998,0,1242,1348,1,8,-7
1998,0,1293,1348,9,8,1
1998,1,1246,1354,2,15,-13
1998,1,1246,1387,2,10,-8
1998,0,1269,1387,7,10,-3
1998,1,1246,1417,2,6,-4
1998,0,1274,1417,11,6,5
1998,0,1276,1417,3,6,-3
1998,1,1246,1390,2,3,-1
1998,0,1158,1390,14,3,11
1998,0,1348,1390,8,3,5
1998,0,1345,1390,2,3,-1
1998,0,1172,1276,14,3,11
1998,0,1139,1307,13,4,9
1998,0,1155,1444,6,11,-5
1998,1,1390,1444,3,11,-8
1998,1,1277,1343,4,5,-1
1999,1,1116,1373,4,13,-9
1999,0,1116,1234,4,5,-1
1999,1,1163,1234,1,5,-4
1999,1,1120,1457,1,16,-15
1999,1,1120,1329,1,9,-8
1999,0,1120,1326,1,4,-3
1999,1,1163,1326,1,4,-3
1999,0,1178,1326,12,4,8
1999,0,1293,1326,13,4,9
1999,1,1163,1427,1,16,-15
1999,1,1163,1307,1,9,-8
1999,0,1281,1307,8,9,-1
1999,1,1163,1211,1,10,-9
1999,0,1196,1211,6,10,-4
1999,1,1163,1181,1,1,0
1999,1,1166,1257,10,7,3
1999,0,1166,1268,10,2,8
1999,1,1178,1417,12,5,7
1999,1,1196,1335,6,11,-5
1999,1,1196,1451,6,14,-8
1999,0,1314,1451,3,14,-11
1999,1,1211,1278,10,7,3
1999,1,1211,1390,10,2,8
1999,0,1108,1390,15,2,13
1999,0,1203,1231,11,6,5
1999,1,1234,1412,5,12,-7
1999,1,1268,1434,2,15,-13
1999,0,1268,1385,2,3,-1
1999,0,1359,1385,14,3,11
1999,0,1231,1385,6,3,3
1999,1,1326,1385,4,3,1
1999,1,1329,1393,9,8,1
1999,1,1150,1348,5,12,-7
1999,0,1150,1328,5,13,-8
1999,1,1277,1328,1,13,-12
1999,0,1112,1328,4,13,-9
1999,1,1153,1206,3,14,-11
1999,0,1153,1396,3,6,-3
1999,1,1181,1396,1,6,-5
1999,0,1345,1396,10,6,4
1999,0,1245,1396,11,6,5
1999,1,1181,1197,1,16,-15
1999,1,1181,1409,1,9,-8
1999,0,1158,1409,8,9,-1
1999,1,1181,1283,1,12,-11
1999,1,1181,1277,1,1,0
1999,0,1246,1277,3,1,2
1999,0,1191,1242,11,6,5
1999,1,1246,1308,3,14,-11
1999,1,1246,1275,3,10,-7
1999,0,1248,1274,15,2,13
1999,1,1275,1449,10,7,3
1999,1,1275,1428,10,2,8
1999,0,1117,1428,15,2,13
1999,1,1277,1291,1,16,-15
1999,1,1277,1279,1,9,-8
1999,1,1279,1437,9,8,1
1999,1,1283,1458,12,5,7
1999,1,1283,1397,12,4,8
1999,0,1174,1397,13,4,9
1999,1,1345,1400,10,7,3
1999,0,1242,1246,6,3,3
1999,0,1274,1345,2,10,-8
2000,1,1112,1238,1,16,-15
2000,0,1112,1458,1,8,-7
2000,0,1261,1458,4,8,-4
2000,1,1277,1458,1,8,-7
2000,0,1201,1458,9,8,1
2000,0,1345,1458,6,8,-2
2000,1,1120,1166,7,10,-3
2000,0,1120,1235,7,2,5
2000,0,1148,1235,15,2,13
2000,1,1211,1257,10,7,3
2000,1,1211,1385,10,2,8
2000,0,1319,1385,15,2,13
2000,0,1211,1345,10,6,4
2000,0,1328,1345,3,6,-3
2000,0,1173,1345,11,6,5
2000,1,1246,1382,5,12,-7
2000,0,1246,1393,5,4,1
2000,1,1277,1393,1,4,-3
2000,0,1359,1393,13,4,9
2000,1,1261,1369,4,13,-9
2000,1,1261,1400,4,5,-1
2000,0,1232,1400,12,5,7
2000,0,1233,1268,14,3,11
2000,1,1277,1434,1,16,-15
2000,1,1277,1428,1,8,-7
2000,0,1387,1428,9,8,1
2000,1,1328,1457,3,14,-11
2000,0,1123,1417,11,6,5
2000,0,1268,1417,3,6,-3
2000,1,1235,1417,2,6,-4
2000,1,1153,1423,2,15,-13
2000,0,1153,1409,2,7,-5
2000,0,1274,1409,6,7,-1
2000,1,1314,1409,8,7,1
2000,1,1163,1429,5,12,-7
2000,0,1163,1397,5,4,1
2000,1,1314,1397,8,4,4
2000,1,1181,1249,1,16,-15
2000,1,1181,1242,1,8,-7
2000,0,1177,1242,9,8,1
2000,0,1181,1196,1,5,-4
2000,0,1139,1196,12,5,7
2000,1,1228,1335,4,13,-9
2000,0,1116,1274,11,6,5
2000,0,1281,1314,9,8,1
2000,1,1196,1314,5,8,-3
2000,0,1111,1326,14,3,11
2000,1,1274,1326,6,3,3
2000,0,1220,1329,14,3,11
2000,1,1196,1329,5,3,2
2000,0,1231,1337,6,11,-5
2000,1,1329,1337,3,11,-8
2000,0,1332,1371,7,10,-3
2000,1,1329,1371,3,10,-7
2000,0,1354,1390,16,1,15
2000,1,1314,1390,8,1,7
2000,0,1248,1396,15,2,13
2000,1,1371,1396,10,2,8
2000,1,1397,1418,4,13,-9
2000,1,1409,1424,7,10,-3
2000,1,1196,1228,5,4,1
2000,0,1196,1277,5,1,4
2000,0,1235,1277,2,1,1
2001,1,1130,1381,3,14,-11
2001,0,1130,1425,3,6,-3
2001,1,1181,1425,1,6,-5
2001,0,1329,1425,11,6,5
2001,0,1246,1425,2,6,-4
2001,0,1140,1153,12,5,7
2001,1,1181,1284,1,16,-15
2001,1,1181,1281,1,9,-8
2001,0,1208,1281,8,9,-1
2001,1,1181,1417,1,4,-3
2001,0,1220,1417,13,4,9
2001,1,1181,1268,1,3,-2
2001,0,1209,1268,11,3,8
2001,0,1206,1268,14,3,11
2001,0,1207,1268,10,3,7
2001,0,1116,1207,7,10,-3
2001,1,1209,1458,11,6,5
2001,1,1214,1235,15,2,13
2001,0,1166,1234,10,7,3
2001,0,1231,1245,4,13,-9
2001,1,1153,1245,5,13,-8
2001,0,1221,1246,15,2,13
2001,0,1234,1246,7,2,5
2001,0,1210,1386,8,9,-1
2001,1,1390,1422,1,16,-15
2001,0,1326,1429,5,12,-7
2001,1,1417,1429,4,12,-8
2001,1,1112,1183,2,15,-13
2001,1,1112,1139,2,10,-8
2001,1,1112,1279,2,3,-1
2001,0,1233,1279,14,3,11
2001,1,1112,1228,2,1,1
2001,0,1150,1228,9,1,8
2001,1,1112,1277,2,1,1
2001,0,1211,1277,12,1,11
2001,0,1106,1277,16,1,15
2001,0,1201,1277,9,1,8
2001,0,1112,1181,2,1,1
2001,1,1139,1448,10,7,3
2001,1,1150,1397,9,8,1
2001,1,1196,1443,3,14,-11
2001,0,1196,1396,3,11,-8
2001,0,1336,1396,7,11,-4
2001,1,1277,1396,1,11,-10
2001,0,1143,1201,8,9,-1
2001,1,1211,1438,12,5,7
2001,1,1211,1232,12,13,-1
2001,1,1228,1322,1,16,-15
2001,1,1228,1242,1,4,-3
2001,0,1169,1242,13,4,9
2001,1,1232,1328,13,4,9
2001,1,1314,1343,2,15,-13
2001,0,1314,1336,2,7,-5
2001,1,1323,1462,6,11,-5
2001,1,1336,1344,7,10,-3
2001,0,1218,1393,12,5,7
2001,1,1242,1393,4,5,-1
2001,1,1396,1400,11,6,5
2001,0,1153,1390,5,1,4
2001,0,1386,1390,9,1,8
2001,1,1268,1390,3,1,2
2001,1,1207,1214,10,15,-5
2001,1,1279,1323,3,6,-3
2002,1,1268,1373,1,16,-15
2002,1,1104,1194,2,15,-13
2002,0,1104,1245,2,10,-8
2002,1,1231,1245,5,10,-5
2002,1,1112,1364,3,14,-11
2002,1,1112,1461,3,11,-8
2002,0,1211,1461,6,11,-5
2002,0,1112,1328,3,2,1
2002,1,1231,1328,5,2,3
2002,0,1227,1328,15,2,13
2002,0,1281,1328,12,2,10
2002,1,1181,1457,1,16,-15
2002,1,1181,1323,1,8,-7
2002,0,1150,1323,9,8,1
2002,0,1181,1231,1,5,-4
2002,1,1231,1428,5,12,-7
2002,1,1231,1423,5,13,-8
2002,0,1231,1268,5,1,4
2002,0,1246,1268,4,1,3
2002,0,1163,1268,2,1,1
2002,0,1242,1268,1,1,0
2002,0,1221,1242,16,1,15
2002,0,1228,1242,4,1,3
2002,1,1245,1329,10,7,3
2002,1,1245,1338,10,3,7
2002,0,1143,1338,6,3,3
2002,0,1148,1338,14,3,11
2002,1,1246,1434,4,13,-9
2002,1,1246,1409,4,12,-8
2002,0,1266,1409,5,12,-7
2002,0,1274,1281,5,12,-7
2002,0,1172,1326,13,4,9
2002,1,1281,1326,12,4,8
2002,0,1285,1332,15,2,13
2002,1,1242,1332,1,2,-1
2002,1,1390,1443,8,9,-1
2002,1,1423,1425,13,4,9
2002,0,1337,1448,10,7,3
2002,1,1332,1448,2,7,-5
2002,1,1143,1335,6,11,-5
2002,0,1131,1153,16,1,15
2002,1,1163,1214,2,15,-13
2002,1,1163,1301,2,7,-5
2002,0,1277,1301,10,7,3
2002,1,1163,1356,2,11,-9
2002,0,1208,1356,3,11,-8
2002,1,1166,1196,12,5,7
2002,0,1166,1228,12,4,8
2002,1,1208,1293,3,14,-11
2002,1,1228,1361,4,13,-9
2002,1,1268,1458,1,8,-7
2002,0,1385,1458,9,8,1
2002,0,1270,1280,14,3,11
2002,1,1356,1403,11,6,5
2002,0,1130,1400,11,6,5
2002,1,1332,1400,2,6,-4
2002,0,1280,1400,3,6,-3
2002,0,1279,1417,9,8,1
2002,1,1281,1417,12,8,4
2002,0,1153,1417,1,8,-7
2002,0,1218,1462,10,7,3
2002,1,1328,1462,2,7,-5
2002,1,1242,1390,1,8,-7
2003,1,1400,1421,1,16,-15
2003,1,1112,1436,1,16,-15
2003,1,1112,1211,1,9,-8
2003,0,1153,1211,8,9,-1
2003,1,1112,1323,1,5,-4
2003,0,1228,1323,4,5,-1
2003,0,1112,1242,1,2,-1
2003,0,1113,1242,10,2,8
2003,0,1181,1242,3,2,1
2003,1,1113,1272,10,7,3
2003,1,1141,1166,11,6,5
2003,0,1141,1181,11,3,8
2003,0,1161,1181,14,3,11
2003,1,1143,1301,8,9,-1
2003,0,1143,1328,8,1,7
2003,0,1139,1328,12,1,11
2003,0,1140,1163,12,5,7
2003,1,1228,1443,4,13,-9
2003,1,1242,1429,2,15,-13
2003,1,1242,1266,2,3,-1
2003,0,1221,1266,14,3,11
2003,0,1246,1266,1,3,-2
2003,0,1242,1393,2,3,-1
2003,0,1328,1393,1,3,-2
2003,0,1120,1393,10,3,7
2003,0,1329,1393,6,3,3
2003,0,1264,1393,14,3,11
2003,1,1281,1356,6,11,-5
2003,1,1323,1454,5,12,-7
2003,1,1328,1354,1,16,-15
2003,0,1360,1390,13,4,9
2003,1,1163,1390,5,4,1
2003,0,1173,1409,4,13,-9
2003,0,1451,1458,12,5,7
2003,0,1409,1458,13,5,8
2003,1,1246,1458,1,5,-4
2003,1,1120,1386,10,7,3
2003,1,1120,1448,10,2,8
2003,0,1190,1448,15,2,13
2003,1,1139,1280,12,5,7
2003,1,1139,1257,12,4,8
2003,0,1122,1257,13,4,9
2003,1,1196,1358,2,15,-13
2003,0,1196,1277,2,7,-5
2003,0,1268,1277,6,7,-1
2003,0,1160,1277,10,7,3
2003,0,1104,1231,10,7,3
2003,0,1237,1246,16,1,15
2003,1,1268,1423,6,11,-5
2003,1,1268,1462,6,3,3
2003,0,1407,1462,14,3,11
2003,1,1329,1335,6,11,-5
2003,1,1338,1447,2,15,-13
2003,0,1261,1345,8,9,-1
2003,0,1332,1428,8,9,-1
2003,1,1246,1428,1,9,-8
2003,0,1163,1400,5,1,4
2003,0,1345,1400,9,1,8
2003,0,1277,1400,7,1,6
2003,1,1393,1400,3,1,2
2003,1,1266,1281,3,6,-3
2003,1,1266,1338,3,2,1
2003,0,1231,1338,7,2,5
2004,0,1197,1246,16,1,15
2004,1,1104,1356,8,9,-1
2004,1,1104,1390,8,1,7
2004,1,1104,1393,8,5,3
2004,0,1268,1393,4,5,-1
2004,0,1140,1393,12,5,7
2004,0,1104,1163,8,2,6
2004,1,1163,1436,2,15,-13
2004,1,1163,1177,2,7,-5
2004,0,1173,1177,10,7,3
2004,1,1163,1435,2,6,-4
2004,0,1301,1435,3,6,-3
2004,1,1163,1181,2,1,1
2004,0,1106,1181,16,1,15
2004,1,1163,1210,2,3,-1
2004,0,1130,1210,6,3,3
2004,1,1211,1434,2,15,-13
2004,0,1211,1305,2,10,-8
2004,0,1277,1305,7,10,-3
2004,1,1210,1305,3,10,-7
2004,0,1196,1264,5,12,-7
2004,1,1268,1431,4,13,-9
2004,0,1102,1314,11,6,5
2004,0,1112,1371,9,8,1
2004,1,1181,1371,1,8,-7
2004,0,1251,1386,16,1,15
2004,1,1329,1386,2,1,1
2004,1,1390,1427,1,16,-15
2004,0,1343,1400,14,3,11
2004,0,1314,1400,6,3,3
2004,0,1150,1403,9,8,1
2004,1,1386,1403,1,8,-7
2004,0,1433,1448,13,4,9
2004,1,1386,1448,1,4,-3
2004,0,1264,1448,12,4,8
2004,1,1130,1428,6,11,-5
2004,1,1153,1190,4,13,-9
2004,0,1153,1228,4,5,-1
2004,1,1181,1228,1,5,-4
2004,1,1210,1320,3,14,-11
2004,1,1210,1242,3,4,-1
2004,0,1227,1242,13,4,9
2004,1,1210,1329,3,2,1
2004,0,1272,1329,7,2,5
2004,0,1186,1329,15,2,13
2004,1,1228,1293,5,12,-7
2004,1,1272,1376,7,10,-3
2004,1,1280,1284,2,15,-13
2004,0,1280,1462,2,7,-5
2004,0,1257,1462,10,7,3
2004,1,1181,1462,1,7,-6
2004,0,1400,1462,3,7,-4
2004,1,1301,1418,3,14,-11
2004,1,1334,1344,12,5,7
2004,1,1338,1416,3,14,-11
2004,1,1338,1458,3,6,-3
2004,0,1350,1458,11,6,5
2004,1,1412,1449,9,8,1
2004,1,1435,1444,6,11,-5
2004,1,1242,1334,4,12,-8
2004,1,1242,1412,4,9,-5
2004,0,1246,1412,1,9,-8
2004,1,1329,1338,2,3,-1
2005,1,1314,1324,1,16,-15
2005,1,1112,1429,3,14,-11
2005,1,1112,1412,3,11,-8
2005,0,1261,1412,6,11,-5
2005,1,1112,1329,3,2,1
2005,0,1112,1228,3,1,2
2005,0,1192,1228,16,1,15
2005,1,1130,1335,4,13,-9
2005,0,1130,1454,4,12,-8
2005,0,1104,1454,5,12,-7
2005,1,1228,1454,1,12,-11
2005,1,1153,1234,7,10,-3
2005,0,1153,1246,7,2,5
2005,0,1184,1246,15,2,13
2005,1,1211,1457,3,14,-11
2005,0,1211,1403,3,6,-3
2005,1,1305,1400,9,8,1
2005,0,1310,1328,14,3,11
2005,1,1334,1338,8,9,-1
2005,0,1334,1449,8,1,7
2005,0,1285,1449,16,1,15
2005,1,1257,1449,4,1,3
2005,1,1403,1417,6,11,-5
2005,0,1403,1452,6,7,-1
2005,0,1166,1452,10,7,3
2005,1,1257,1452,4,7,-3
2005,0,1448,1452,2,7,-5
2005,1,1428,1431,6,11,-5
2005,0,1151,1448,15,2,13
2005,1,1137,1242,14,3,11
2005,0,1137,1458,14,6,8
2005,1,1314,1458,1,6,-5
2005,0,1320,1458,11,6,5
2005,0,1301,1458,10,6,4
2005,1,1163,1416,2,15,-13
2005,0,1163,1301,2,10,-8
2005,0,1150,1301,7,10,-3
2005,0,1175,1181,16,1,15
2005,1,1196,1325,4,13,-9
2005,0,1196,1437,4,5,-1
2005,1,1314,1437,1,5,-4
2005,0,1307,1437,12,5,7
2005,0,1203,1210,12,5,7
2005,1,1235,1278,9,8,1
2005,0,1235,1314,9,1,8
2005,0,1277,1314,5,1,4
2005,0,1228,1314,1,1,0
2005,1,1257,1418,4,13,-9
2005,1,1277,1330,5,12,-7
2005,1,1277,1436,5,13,-8
2005,0,1393,1436,4,13,-9
2005,1,1280,1390,9,8,1
2005,1,1329,1368,2,15,-13
2005,1,1329,1356,2,7,-5
2005,1,1356,1388,7,10,-3
2005,1,1228,1305,1,9,-8
2005,1,1228,1257,1,4,-3
2005,0,1210,1257,5,4,1
2005,0,1328,1428,3,6,-3
2005,1,1246,1428,2,6,-4
2005,1,1181,1280,1,9,-8
2005,0,1181,1277,1,5,-4
2005,0,1246,1277,2,5,-3
2006,1,1104,1266,10,7,3
2006,0,1104,1417,10,2,8
2006,1,1196,1417,3,2,1
2006,0,1211,1417,3,2,1
2006,0,1125,1417,15,2,13
2006,0,1272,1417,1,2,-1
2006,0,1261,1417,4,2,2
2006,1,1130,1334,4,13,-9
2006,1,1130,1285,4,12,-8
2006,0,1130,1437,4,1,3
2006,1,1196,1437,3,1,2
2006,0,1112,1437,8,1,7
2006,0,1284,1437,16,1,15
2006,1,1181,1380,1,16,-15
2006,1,1181,1203,1,8,-7
2006,0,1181,1261,1,4,-3
2006,0,1233,1261,13,4,9
2006,1,1196,1375,3,14,-11
2006,1,1196,1454,3,11,-8
2006,0,1328,1454,6,11,-5
2006,1,1196,1207,3,7,-4
2006,1,1196,1206,3,11,-8
2006,0,1163,1206,1,11,-10
2006,1,1203,1423,8,9,-1
2006,1,1211,1462,3,14,-11
2006,1,1211,1231,3,6,-3
2006,0,1102,1228,13,4,9
2006,1,1231,1361,6,11,-5
2006,1,1285,1305,12,5,7
2006,1,1397,1457,2,15,-13
2006,0,1397,1455,2,7,-5
2006,0,1371,1455,10,7,3
2006,1,1206,1455,11,7,4
2006,0,1393,1401,5,12,-7
2006,1,1261,1401,4,12,-8
2006,0,1429,1449,12,5,7
2006,0,1228,1449,4,5,-1
2006,1,1163,1449,1,5,-4
2006,1,1112,1458,8,9,-1
2006,1,1133,1242,13,4,9
2006,1,1133,1338,13,5,8
2006,0,1245,1338,12,5,7
2006,0,1133,1272,13,1,12
2006,0,1137,1272,9,1,8
2006,0,1116,1137,8,9,-1
2006,0,1107,1163,16,1,15
2006,1,1206,1277,11,6,5
2006,1,1206,1314,11,3,8
2006,0,1293,1314,14,3,11
2006,1,1207,1320,7,10,-3
2006,1,1207,1326,7,2,5
2006,0,1172,1326,15,2,13
2006,1,1246,1412,8,9,-1
2006,1,1272,1331,1,16,-15
2006,0,1143,1301,7,10,-3
2006,0,1234,1322,3,14,-11
2006,0,1335,1400,15,2,13
2006,1,1261,1400,4,2,2
2006,0,1301,1400,10,2,8
2006,0,1356,1452,11,6,5
2006,0,1322,1452,14,6,8
2006,1,1400,1452,2,6,-4
2006,1,1163,1246,1,8,-7
2007,1,1242,1310,1,16,-15
2007,1,1130,1403,7,10,-3
2007,0,1130,1207,7,2,5
2007,0,1125,1207,15,2,13
2007,1,1139,1330,5,12,-7
2007,1,1139,1268,5,4,1
2007,0,1172,1268,13,4,9
2007,0,1139,1196,5,1,4
2007,0,1211,1231,10,7,3
2007,1,1257,1390,6,11,-5
2007,0,1257,1401,6,3,3
2007,0,1335,1401,14,3,11
2007,1,1272,1401,2,3,-1
2007,0,1266,1277,8,9,-1
2007,0,1184,1314,16,1,15
2007,0,1277,1314,9,1,8
2007,1,1207,1314,2,1,1
2007,0,1148,1326,16,1,15
2007,1,1196,1326,1,1,0
2007,0,1272,1326,2,1,1
2007,0,1207,1326,2,1,1
2007,1,1338,1460,3,14,-11
2007,1,1338,1433,3,11,-8
2007,0,1181,1433,6,11,-5
2007,0,1338,1417,3,2,1
2007,1,1196,1417,1,2,-1
2007,0,1242,1417,1,2,-1
2007,0,1231,1417,7,2,5
2007,1,1417,1451,2,15,-13
2007,0,1203,1435,11,6,5
2007,1,1207,1435,2,6,-4
2007,0,1331,1450,14,3,11
2007,1,1435,1450,6,3,3
2007,0,1140,1462,8,9,-1
2007,1,1326,1462,1,9,-8
2007,1,1196,1238,1,16,-15
2007,1,1196,1345,1,9,-8
2007,0,1112,1345,8,9,-1
2007,1,1196,1332,1,3,-2
2007,0,1275,1332,14,3,11
2007,1,1242,1246,1,8,-7
2007,1,1242,1356,1,4,-3
2007,0,1221,1356,13,4,9
2007,1,1246,1437,8,9,-1
2007,1,1272,1317,2,15,-13
2007,1,1272,1305,2,7,-5
2007,0,1166,1305,10,7,3
2007,0,1253,1397,12,5,7
2007,1,1326,1397,1,5,-4
2007,0,1308,1400,13,4,9
2007,0,1210,1424,10,7,3
2007,1,1332,1424,3,7,-4
2007,0,1116,1425,12,5,7
2007,0,1400,1425,4,5,-1
2007,1,1314,1425,1,5,-4
2007,0,1107,1438,13,4,9
2007,1,1397,1438,5,4,1
2007,0,1228,1439,12,5,7
2007,1,1356,1439,4,5,-1
2007,0,1323,1457,6,11,-5
2007,1,1332,1457,3,11,-8
2007,0,1394,1458,15,2,13
2007,1,1424,1458,7,2,5
2008,0,1125,1181,15,2,13
2008,1,1242,1340,1,16,-15
2008,1,1242,1424,1,8,-7
2008,0,1245,1424,9,8,1
2008,1,1242,1437,1,12,-11
2008,0,1373,1437,13,12,1
2008,0,1155,1437,5,12,-7
2008,1,1242,1314,1,1,0
2008,0,1116,1314,9,1,8
2008,0,1291,1314,16,1,15
2008,0,1257,1314,3,1,2
2008,1,1242,1272,1,1,0
2008,1,1243,1425,11,6,5
2008,0,1243,1458,11,3,8
2008,0,1168,1458,14,3,11
2008,1,1172,1458,10,3,7
2008,0,1246,1266,11,6,5
2008,1,1277,1396,5,12,-7
2008,1,1277,1338,5,4,1
2008,0,1331,1338,13,4,9
2008,0,1206,1323,12,5,7
2008,0,1124,1345,11,6,5
2008,0,1165,1390,14,3,11
2008,0,1266,1390,6,3,3
2008,0,1140,1401,8,9,-1
2008,0,1290,1417,16,1,15
2008,1,1272,1417,1,1,0
2008,0,1401,1417,9,1,8
2008,1,1450,1457,4,13,-9
2008,0,1112,1452,10,7,3
2008,0,1181,1452,2,7,-5
2008,0,1208,1462,14,3,11
2008,0,1345,1462,6,3,3
2008,1,1417,1462,1,3,-2
2008,0,1452,1462,7,3,4
2008,1,1116,1231,9,8,1
2008,1,1139,1375,7,10,-3
2008,0,1139,1397,7,2,5
2008,0,1110,1397,15,2,13
2008,1,1257,1397,3,2,1
2008,1,1172,1211,10,7,3
2008,1,1172,1207,10,2,8
2008,0,1172,1242,10,1,9
2008,1,1207,1420,2,15,-13
2008,0,1129,1257,14,3,11
2008,1,1272,1426,1,16,-15
2008,1,1272,1280,1,8,-7
2008,1,1272,1277,1,5,-4
2008,1,1272,1400,1,2,-1
2008,0,1274,1400,7,2,5
2008,0,1122,1400,15,2,13
2008,0,1390,1400,3,2,1
2008,1,1274,1388,7,10,-3
2008,1,1280,1332,8,9,-1
2008,1,1328,1386,6,11,-5
2008,0,1163,1360,4,13,-9
2008,1,1373,1435,13,4,9
2008,0,1179,1443,5,12,-7
2008,0,1360,1443,13,12,1
2008,1,1417,1443,1,12,-11
2008,0,1323,1450,5,4,1
2008,1,1314,1450,1,4,-3
2008,1,1257,1328,3,6,-3
2009,1,1257,1287,1,16,-15
2009,0,1151,1163,16,1,15
2009,0,1127,1181,15,2,13
2009,0,1103,1211,13,4,9
2009,0,1139,1261,9,8,1
2009,0,1143,1268,7,10,-3
2009,0,1169,1272,15,2,13
2009,0,1268,1272,10,2,8
2009,0,1155,1276,7,10,-3
2009,1,1314,1347,1,16,-15
2009,1,1314,1328,1,2,-1
2009,0,1288,1328,15,2,13
2009,0,1276,1328,10,2,8
2009,1,1314,1437,1,3,-2
2009,0,1417,1437,6,3,3
2009,0,1110,1437,14,3,11
2009,0,1181,1437,2,3,-1
2009,0,1338,1437,1,3,-2
2009,0,1320,1345,12,5,7
2009,1,1163,1345,1,5,-4
2009,0,1278,1400,10,7,3
2009,1,1181,1400,2,7,-5
2009,0,1140,1401,8,9,-1
2009,1,1163,1401,1,9,-8
2009,1,1417,1433,6,11,-5
2009,0,1228,1443,5,12,-7
2009,1,1211,1443,4,12,-8
2009,0,1280,1449,13,4,9
2009,1,1345,1449,5,4,1
2009,1,1112,1428,12,5,7
2009,1,1112,1156,12,13,-1
2009,0,1112,1257,12,1,11
2009,1,1113,1396,6,11,-5
2009,0,1113,1393,6,3,3
2009,0,1372,1393,14,3,11
2009,1,1328,1393,2,3,-1
2009,1,1156,1448,13,4,9
2009,1,1173,1452,11,6,5
2009,0,1173,1242,11,3,8
2009,1,1242,1295,3,14,-11
2009,0,1242,1277,3,2,1
2009,0,1257,1277,1,2,-1
2009,0,1163,1277,1,2,-1
2009,1,1257,1373,1,9,-8
2009,0,1326,1373,8,9,-1
2009,1,1266,1429,6,11,-5
2009,0,1266,1281,6,3,3
2009,0,1165,1281,14,3,11
2009,1,1163,1281,1,3,-2
2009,0,1272,1281,2,3,-1
2009,1,1277,1352,2,15,-13
2009,1,1277,1425,2,10,-8
2009,0,1130,1425,7,10,-3
2009,0,1277,1314,2,1,1
2009,0,1211,1314,4,1,3
2009,0,1261,1314,8,1,7
2009,1,1329,1397,8,9,-1
2009,0,1329,1338,8,1,7
2009,0,1190,1338,16,1,15
2009,0,1199,1458,5,12,-7
2009,0,1340,1462,13,4,9
2009,0,1458,1462,12,4,8
2009,1,1338,1462,1,4,-3
2010,0,1115,1181,16,1,15
2010,0,1124,1181,3,1,2
2010,0,1139,1181,5,1,4
2010,0,1143,1181,8,1,7
2010,1,1124,1358,3,14,-11
2010,1,1124,1330,3,11,-8
2010,0,1323,1330,6,11,-5
2010,1,1124,1388,3,10,-7
2010,0,1350,1388,7,10,-3
2010,1,1139,1431,5,12,-7
2010,1,1139,1293,5,13,-8
2010,1,1139,1393,5,1,4
2010,0,1211,1393,8,1,7
2010,1,1139,1243,5,2,3
2010,0,1140,1243,7,2,5
2010,1,1139,1277,5,5,0
2010,0,1268,1277,4,5,-1
2010,1,1140,1196,7,10,-3
2010,1,1242,1250,1,16,-15
2010,0,1242,1320,1,9,-8
2010,1,1277,1320,5,9,-4
2010,1,1243,1317,2,15,-13
2010,1,1243,1462,2,6,-4
2010,0,1278,1462,11,6,5
2010,0,1338,1462,3,6,-3
2010,0,1190,1246,16,1,15
2010,0,1165,1246,12,1,11
2010,1,1293,1435,13,4,9
2010,0,1285,1307,14,3,11
2010,1,1320,1424,9,8,1
2010,0,1207,1325,3,14,-11
2010,0,1361,1397,11,6,5
2010,1,1277,1397,5,6,-1
2010,0,1326,1397,2,6,-4
2010,0,1325,1397,14,6,8
2010,0,1352,1437,15,2,13
2010,1,1388,1437,10,2,8
2010,0,1400,1448,8,9,-1
2010,1,1246,1448,1,9,-8
2010,0,1266,1449,6,11,-5
2010,0,1307,1449,3,11,-8
2010,1,1143,1257,8,9,-1
2010,1,1165,1396,12,5,7
2010,1,1165,1458,12,4,8
2010,1,1210,1329,10,7,3
2010,0,1210,1326,10,2,8
2010,0,1199,1211,9,8,1
2010,0,1222,1268,13,4,9
2010,1,1277,1308,5,12,-7
2010,0,1155,1281,7,10,-3
2010,1,1326,1364,2,15,-13
2010,0,1324,1338,14,3,11
2010,1,1345,1373,4,13,-9
2010,1,1345,1401,4,5,-1
2010,1,1393,1436,1,16,-15
2010,1,1401,1429,5,12,-7
2010,0,1288,1452,15,2,13
2010,0,1246,1452,1,2,-1
2010,0,1281,1452,10,2,8
2010,0,1449,1452,11,2,9
2010,1,1181,1452,1,2,-1
2010,1,1458,1459,4,13,-9
2010,1,1181,1345,1,4,-3
2011,0,1155,1452,12,5,7
2011,1,1246,1452,4,5,-1
2011,1,1338,1421,1,16,-15
2011,1,1326,1427,1,16,-15
2011,1,1139,1433,8,11,-3
2011,0,1199,1433,10,11,-1
2011,0,1345,1433,3,11,-8
2011,0,1207,1433,6,11,-5
2011,0,1242,1433,1,11,-10
2011,1,1139,1330,8,9,-1
2011,1,1139,1338,8,1,7
2011,1,1139,1458,8,4,4
2011,0,1243,1458,5,4,1
2011,0,1125,1458,13,4,9
2011,1,1139,1196,8,2,6
2011,0,1140,1196,3,2,1
2011,0,1139,1163,8,3,5
2011,0,1153,1163,6,3,3
2011,0,1137,1163,14,3,11
2011,0,1112,1163,5,3,2
2011,1,1140,1459,3,14,-11
2011,1,1140,1211,3,11,-8
2011,1,1153,1281,6,11,-5
2011,1,1196,1364,2,15,-13
2011,1,1196,1417,2,7,-5
2011,0,1277,1417,10,7,3
2011,1,1211,1385,11,6,5
2011,1,1243,1429,5,12,-7
2011,1,1246,1343,4,13,-9
2011,1,1246,1326,4,1,3
2011,0,1206,1326,8,1,7
2011,1,1246,1314,4,2,2
2011,0,1266,1314,11,2,9
2011,0,1254,1314,15,2,13
2011,0,1257,1287,4,13,-9
2011,1,1350,1435,12,5,7
2011,0,1294,1361,15,2,13
2011,1,1163,1361,3,2,1
2011,0,1336,1396,10,7,3
2011,1,1361,1396,2,7,-5
2011,1,1112,1272,5,12,-7
2011,1,1112,1400,5,4,1
2011,0,1324,1400,13,4,9
2011,1,1112,1181,5,1,4
2011,1,1181,1214,1,16,-15
2011,1,1181,1276,1,8,-7
2011,1,1199,1401,10,7,3
2011,1,1199,1323,10,2,8
2011,0,1103,1323,15,2,13
2011,1,1206,1437,8,9,-1
2011,1,1228,1424,9,8,1
2011,0,1228,1242,9,1,8
2011,0,1131,1242,16,1,15
2011,1,1266,1462,11,6,5
2011,1,1266,1393,11,3,8
2011,0,1232,1393,14,3,11
2011,1,1276,1397,8,9,-1
2011,1,1345,1389,3,14,-11
2011,0,1208,1449,10,7,3
2011,1,1314,1449,2,7,-5
2011,0,1287,1350,13,12,1
2011,1,1242,1350,1,12,-11
2011,1,1163,1246,3,4,-1
2012,0,1140,1266,14,3,11
2012,1,1196,1266,7,3,4
2012,1,1246,1443,1,16,-15
2012,1,1325,1378,13,12,1
2012,1,1314,1436,1,16,-15
2012,1,1124,1355,3,14,-11
2012,1,1124,1160,3,11,-8
2012,1,1124,1462,3,10,-7
2012,0,1323,1462,7,10,-3
2012,0,1250,1462,15,10,5
2012,0,1124,1246,3,1,2
2012,0,1231,1246,4,1,3
2012,0,1235,1246,8,1,7
2012,0,1242,1246,2,1,1
2012,1,1160,1424,11,6,5
2012,1,1211,1452,7,10,-3
2012,0,1211,1326,7,2,5
2012,0,1259,1326,15,2,13
2012,0,1153,1326,6,2,4
2012,1,1242,1326,2,2,0
2012,1,1231,1308,4,13,-9
2012,1,1231,1433,4,12,-8
2012,0,1163,1235,9,8,1
2012,1,1243,1379,8,9,-1
2012,0,1243,1393,8,1,7
2012,1,1326,1393,2,1,1
2012,1,1246,1257,1,4,-3
2012,0,1172,1257,13,4,9
2012,0,1196,1257,7,4,3
2012,0,1161,1293,11,6,5
2012,1,1266,1293,3,6,-3
2012,0,1253,1307,12,5,7
2012,1,1257,1307,4,5,-1
2012,1,1393,1421,1,16,-15
2012,1,1393,1458,1,4,-3
2012,0,1285,1458,13,4,9
2012,0,1435,1458,5,4,1
2012,1,1433,1455,12,5,7
2012,0,1217,1435,12,5,7
2012,1,1153,1400,6,11,-5
2012,1,1153,1199,6,3,3
2012,0,1104,1166,9,8,1
2012,1,1196,1438,7,10,-3
2012,1,1196,1313,7,15,-8
2012,0,1281,1313,2,15,-13
2012,1,1199,1382,3,14,-11
2012,0,1125,1207,14,3,11
2012,0,1178,1242,15,2,13
2012,0,1181,1250,2,15,-13
2012,0,1254,1277,16,1,15
2012,1,1257,1277,4,1,3
2012,1,1301,1361,11,6,5
2012,1,1314,1325,1,13,-12
2012,0,1276,1325,4,13,-9
2012,1,1345,1388,10,7,3
2012,1,1378,1396,12,5,7
2012,0,1272,1387,8,9,-1
2012,1,1277,1387,1,9,-8
2012,1,1242,1345,2,10,-8
2012,1,1242,1301,2,11,-9
2012,0,1207,1301,3,11,-8
2012,1,1242,1314,2,1,1
2012,0,1166,1314,8,1,7
2013,1,1257,1299,1,16,-15
2013,1,1272,1388,6,11,-5
2013,0,1243,1247,4,13,-9
2013,1,1112,1125,6,11,-5
2013,1,1112,1217,6,14,-8
2013,0,1112,1326,6,2,4
2013,0,1235,1326,10,2,8
2013,0,1233,1326,15,2,13
2013,0,1137,1139,11,6,5
2013,1,1143,1424,12,5,7
2013,0,1143,1393,12,4,8
2013,1,1276,1393,4,4,0
2013,0,1285,1393,13,4,9
2013,0,1231,1393,1,4,-3
2013,0,1266,1393,3,4,-1
2013,1,1161,1281,8,9,-1
2013,0,1161,1257,8,1,7
2013,0,1181,1257,2,1,1
2013,1,1211,1380,1,16,-15
2013,0,1211,1455,1,9,-8
2013,1,1257,1455,1,9,-8
2013,0,1338,1455,8,9,-1
2013,0,1247,1455,13,9,4
2013,0,1326,1455,2,9,-7
2013,1,1217,1307,14,3,11
2013,1,1257,1332,1,12,-11
2013,0,1329,1332,5,12,-7
2013,1,1257,1276,1,4,-3
2013,0,1196,1276,3,4,-1
2013,0,1242,1276,1,4,-3
2013,0,1172,1266,14,3,11
2013,0,1139,1266,6,3,3
2013,0,1272,1277,6,3,3
2013,1,1181,1277,2,3,-1
2013,1,1276,1355,4,13,-9
2013,1,1276,1433,4,5,-1
2013,0,1103,1433,12,5,7
2013,1,1277,1434,3,14,-11
2013,0,1308,1387,13,4,9
2013,1,1332,1387,12,4,8
2013,0,1153,1166,10,7,3
2013,0,1107,1181,15,2,13
2013,0,1166,1181,7,2,5
2013,1,1195,1207,15,2,13
2013,1,1195,1361,15,7,8
2013,0,1328,1361,10,7,3
2013,0,1195,1196,15,3,12
2013,1,1196,1322,3,14,-11
2013,1,1196,1278,3,11,-8
2013,0,1160,1228,10,7,3
2013,1,1231,1241,1,16,-15
2013,1,1231,1396,1,9,-8
2013,0,1301,1396,8,9,-1
2013,1,1235,1323,10,7,3
2013,1,1242,1443,1,16,-15
2013,1,1242,1314,1,8,-7
2013,1,1274,1334,2,15,-13
2013,1,1278,1417,11,6,5
2013,1,1279,1458,12,5,7
2013,1,1314,1437,8,9,-1
2013,1,1247,1279,13,12,1
2013,0,1228,1274,7,2,5
2013,1,1266,1274,3,2,1
2014,0,1107,1196,16,1,15
2014,1,1163,1196,7,1,6
2014,0,1173,1196,11,1,10
2014,0,1301,1387,12,5,7
2014,1,1257,1387,4,5,-1
2014,0,1142,1455,16,1,15
2014,1,1246,1455,8,1,7
2014,1,1276,1397,2,11,-9
2014,0,1269,1397,6,11,-5
2014,0,1273,1397,14,11,3
2014,1,1163,1386,7,10,-3
2014,1,1163,1437,7,2,5
2014,1,1163,1235,7,3,4
2014,1,1163,1277,7,4,3
2014,0,1174,1277,13,4,9
2014,0,1217,1277,12,4,8
2014,1,1163,1246,7,8,-1
2014,0,1243,1246,9,8,1
2014,1,1173,1326,11,6,5
2014,1,1173,1393,11,3,8
2014,1,1173,1390,11,10,1
2014,0,1307,1390,7,10,-3
2014,0,1242,1390,2,10,-8
2014,0,1153,1217,5,12,-7
2014,1,1257,1264,4,13,-9
2014,1,1276,1459,2,15,-13
2014,1,1276,1400,2,7,-5
2014,0,1113,1400,10,7,3
2014,1,1295,1328,12,5,7
2014,0,1295,1361,12,4,8
2014,0,1308,1361,13,4,9
2014,1,1112,1361,1,4,-3
2014,0,1140,1332,10,7,3
2014,0,1160,1338,8,9,-1
2014,1,1196,1338,1,9,-8
2014,1,1393,1444,3,14,-11
2014,1,1437,1454,2,15,-13
2014,0,1110,1458,15,2,13
2014,0,1112,1458,1,2,-1
2014,0,1124,1458,6,2,4
2014,0,1332,1458,7,2,5
2014,1,1246,1458,8,2,6
2014,1,1112,1451,1,16,-15
2014,1,1112,1211,1,8,-7
2014,1,1124,1304,6,11,-5
2014,1,1124,1166,6,3,3
2014,1,1166,1418,3,14,-11
2014,1,1211,1329,8,9,-1
2014,1,1235,1300,3,14,-11
2014,1,1235,1314,3,6,-3
2014,0,1184,1242,15,2,13
2014,0,1203,1272,9,8,1
2014,0,1181,1273,3,14,-11
2014,1,1314,1344,6,11,-5
2014,1,1372,1433,12,5,7
2014,0,1372,1417,12,4,8
2014,0,1409,1417,13,4,9
2014,1,1196,1417,1,4,-3
2014,0,1157,1438,16,1,15
2014,0,1272,1438,8,1,7
2014,1,1277,1438,4,1,3
2014,1,1246,1257,8,4,4
2014,1,1246,1276,8,2,6
2015,0,1214,1246,16,1,15
2015,0,1153,1246,8,1,7
2015,1,1181,1352,1,16,-15
2015,1,1112,1411,2,15,-13
2015,1,1112,1326,2,10,-8
2015,1,1112,1462,2,6,-4
2015,0,1279,1462,11,6,5
2015,0,1209,1462,14,6,8
2015,0,1112,1458,2,1,1
2015,1,1181,1458,1,1,0
2015,0,1157,1458,16,1,15
2015,0,1332,1458,8,1,7
2015,0,1246,1458,1,1,0
2015,0,1314,1458,4,1,3
2015,1,1116,1459,5,12,-7
2015,0,1116,1314,5,4,1
2015,0,1217,1314,13,4,9
2015,1,1139,1400,6,11,-5
2015,0,1139,1323,6,3,3
2015,0,1318,1323,14,3,11
2015,1,1246,1323,1,3,-2
2015,1,1153,1345,8,9,-1
2015,0,1186,1207,13,4,9
2015,0,1124,1209,3,14,-11
2015,0,1261,1301,9,8,1
2015,1,1257,1301,4,8,-4
2015,1,1326,1433,10,7,3
2015,0,1235,1412,3,14,-11
2015,0,1374,1417,6,11,-5
2015,1,1211,1417,2,11,-9
2015,0,1412,1417,14,11,3
2015,0,1372,1428,12,5,7
2015,1,1181,1428,1,5,-4
2015,0,1207,1428,4,5,-1
2015,0,1248,1437,16,1,15
2015,1,1301,1437,8,1,7
2015,1,1173,1344,11,6,5
2015,0,1173,1328,11,3,8
2015,0,1107,1328,14,3,11
2015,1,1277,1328,7,3,4
2015,1,1181,1361,1,8,-7
2015,1,1181,1211,1,2,-1
2015,1,1181,1277,1,7,-6
2015,0,1257,1277,4,7,-3
2015,0,1208,1277,10,7,3
2015,1,1211,1295,2,15,-13
2015,1,1211,1234,2,7,-5
2015,0,1172,1234,10,7,3
2015,1,1242,1308,2,15,-13
2015,0,1242,1455,2,7,-5
2015,0,1231,1455,10,7,3
2015,1,1323,1455,3,7,-4
2015,1,1257,1414,4,13,-9
2015,1,1257,1320,4,5,-1
2015,1,1268,1434,4,13,-9
2015,0,1268,1452,4,5,-1
2015,0,1138,1452,12,5,7
2015,1,1246,1452,1,5,-4
2015,1,1320,1461,5,12,-7
2015,0,1329,1332,9,8,1
2015,1,1361,1385,8,9,-1
2015,0,1125,1438,15,2,13
2015,1,1277,1438,7,2,5
2016,0,1112,1455,6,11,-5
2016,1,1274,1455,3,11,-8
2016,0,1221,1332,16,1,15
2016,0,1181,1332,4,1,3
2016,1,1328,1332,2,1,1
2016,0,1276,1323,11,6,5
2016,1,1314,1323,1,6,-5
2016,1,1114,1345,12,5,7
2016,0,1114,1235,12,4,8
2016,0,1233,1235,13,4,9
2016,1,1139,1403,9,8,1
2016,0,1139,1438,9,1,8
2016,0,1214,1438,16,1,15
2016,0,1235,1438,4,1,3
2016,1,1393,1438,10,1,9
2016,0,1160,1163,8,9,-1
2016,1,1181,1423,4,13,-9
2016,1,1181,1463,4,12,-8
2016,0,1124,1463,5,12,-7
2016,1,1211,1371,11,6,5
2016,1,1211,1428,11,3,8
2016,0,1201,1428,14,3,11
2016,0,1211,1393,11,10,1
2016,0,1173,1393,7,10,-3
2016,1,1314,1393,1,10,-9
2016,0,1292,1393,15,10,5
2016,0,1151,1231,12,5,7
2016,0,1122,1242,16,1,15
2016,0,1163,1242,9,1,8
2016,1,1246,1392,4,13,-9
2016,0,1138,1274,14,3,11
2016,0,1195,1314,16,1,15
2016,0,1231,1314,5,1,4
2016,1,1344,1425,9,8,1
2016,0,1143,1218,4,13,-9
2016,1,1234,1396,7,10,-3
2016,0,1234,1437,7,2,5
2016,0,1421,1437,15,2,13
2016,0,1274,1437,3,2,1
2016,0,1314,1437,1,2,-1
2016,0,1328,1437,2,2,0
2016,0,1242,1437,1,2,-1
2016,1,1268,1355,5,12,-7
2016,0,1277,1292,2,15,-13
2016,1,1320,1400,11,6,5
2016,0,1320,1401,11,3,8
2016,1,1328,1401,2,3,-1
2016,0,1167,1328,15,2,13
2016,1,1372,1452,14,3,11
2016,0,1153,1386,9,8,1
2016,1,1332,1386,1,8,-7
2016,1,1401,1453,3,14,-11
2016,0,1333,1433,7,10,-3
2016,1,1328,1433,2,10,-8
2016,0,1338,1458,10,7,3
2016,1,1323,1458,6,7,-1
2016,0,1451,1462,15,2,13
2016,1,1458,1462,7,2,5
2016,1,1231,1246,5,4,1
2016,1,1314,1344,1,9,-8
2016,0,1218,1268,13,5,8
2016,1,1242,1268,1,5,-4
2016,1,1323,1372,6,14,-8
2017,0,1291,1437,16,1,15
2017,1,1242,1413,1,16,-15
2017,1,1124,1425,3,11,-8
2017,0,1374,1425,6,11,-5
2017,1,1112,1315,2,15,-13
2017,1,1112,1388,2,7,-5
2017,0,1112,1462,2,11,-9
2017,1,1211,1462,1,11,-10
2017,0,1268,1462,6,11,-5
2017,0,1199,1462,3,11,-8
2017,1,1139,1457,4,13,-9
2017,1,1139,1292,4,12,-8
2017,0,1278,1292,5,12,-7
2017,0,1139,1314,4,1,3
2017,0,1211,1314,1,1,0
2017,0,1116,1314,8,1,7
2017,0,1246,1314,2,1,1
2017,0,1190,1196,13,4,9
2017,0,1195,1199,14,3,11
2017,1,1211,1355,1,16,-15
2017,1,1211,1321,1,8,-7
2017,1,1211,1452,1,4,-3
2017,0,1323,1452,5,4,1
2017,0,1137,1452,13,4,9
2017,1,1211,1376,1,7,-6
2017,0,1124,1376,3,7,-4
2017,0,1181,1376,2,7,-5
2017,0,1266,1376,10,7,3
2017,0,1196,1376,4,7,-3
2017,1,1235,1305,5,12,-7
2017,0,1235,1345,5,4,1
2017,1,1242,1345,1,4,-3
2017,1,1321,1435,8,9,-1
2017,1,1323,1343,5,12,-7
2017,1,1345,1436,4,13,-9
2017,1,1388,1433,7,10,-3
2017,0,1423,1438,12,5,7
2017,1,1196,1438,4,5,-1
2017,0,1439,1458,9,8,1
2017,1,1196,1458,4,8,-4
2017,0,1437,1458,1,8,-7
2017,1,1116,1371,8,9,-1
2017,1,1124,1308,3,14,-11
2017,1,1153,1243,6,11,-5
2017,0,1153,1417,6,3,3
2017,1,1246,1417,2,3,-1
2017,0,1245,1417,14,3,11
2017,1,1181,1407,2,15,-13
2017,1,1242,1277,1,9,-8
2017,0,1274,1277,8,9,-1
2017,0,1242,1332,1,3,-2
2017,0,1276,1332,7,3,4
2017,1,1314,1332,1,3,-2
2017,0,1233,1332,14,3,11
2017,1,1246,1297,2,15,-13
2017,1,1246,1455,2,10,-8
2017,0,1173,1455,7,10,-3
2017,0,1240,1257,15,2,13
2017,1,1276,1329,7,10,-3
2017,1,1314,1411,1,16,-15
2017,0,1166,1348,6,11,-5
2017,1,1332,1348,3,11,-8
2017,0,1257,1276,2,7,-5
2018,1,1181,1393,2,11,-9
2018,0,1277,1393,3,11,-8
2018,1,1104,1439,9,8,1
2018,0,1104,1437,9,1,8
2018,0,1242,1437,1,1,0
2018,0,1276,1437,3,1,2
2018,0,1347,1437,16,1,15
2018,0,1403,1437,3,1,2
2018,0,1112,1138,4,13,-9
2018,1,1181,1233,2,15,-13
2018,1,1181,1348,2,7,-5
2018,0,1328,1348,10,7,3
2018,0,1181,1242,2,1,1
2018,0,1155,1242,5,1,4
2018,1,1196,1382,6,11,-5
2018,0,1196,1403,6,3,3
2018,0,1372,1403,14,3,11
2018,0,1345,1403,2,3,-1
2018,1,1211,1422,4,13,-9
2018,1,1211,1326,4,5,-1
2018,1,1222,1361,6,11,-5
2018,0,1222,1276,6,3,3
2018,0,1260,1276,11,3,8
2018,0,1199,1276,9,3,6
2018,1,1242,1335,1,16,-15
2018,1,1242,1371,1,8,-7
2018,0,1301,1371,9,8,1
2018,0,1172,1246,12,5,7
2018,0,1138,1246,13,5,8
2018,1,1243,1246,9,5,4
2018,1,1260,1274,11,6,5
2018,1,1260,1397,11,3,8
2018,1,1260,1305,11,7,4
2018,0,1153,1305,2,7,-5
2018,1,1276,1285,3,14,-11
2018,1,1276,1401,3,7,-4
2018,0,1344,1401,10,7,3
2018,0,1314,1401,2,7,-5
2018,1,1326,1355,5,12,-7
2018,1,1397,1460,3,14,-11
2018,1,1120,1158,4,13,-9
2018,0,1120,1155,4,5,-1
2018,0,1116,1139,7,10,-3
2018,1,1153,1209,2,15,-13
2018,1,1155,1308,5,12,-7
2018,1,1199,1281,9,8,1
2018,1,1199,1462,9,1,8
2018,0,1411,1462,16,1,15
2018,1,1199,1211,9,4,5
2018,0,1166,1243,8,9,-1
2018,1,1267,1455,13,4,9
2018,0,1267,1452,13,5,8
2018,0,1293,1452,12,5,7
2018,1,1437,1452,1,5,-4
2018,0,1137,1277,14,3,11
2018,1,1305,1400,7,10,-3
2018,0,1252,1314,15,2,13
2018,0,1168,1345,15,2,13
2018,0,1139,1345,10,2,8
2018,1,1393,1395,11,6,5
2018,1,1420,1438,16,1,15
2018,1,1243,1420,9,16,-7
2018,0,1243,1260,9,11,-2
