Season,TeamOneID,TeamTwoID,TeamOneSeed,TeamTwoSeed,SeedDiff
2014,1107,1110,16,15,1
2014,1107,1112,16,1,15
2014,1110,1112,15,1,14
2014,1107,1113,16,10,6
2014,1110,1113,15,10,5
2014,1112,1113,1,10,-9
2014,1107,1124,16,6,10
2014,1110,1124,15,6,9
2014,1112,1124,1,6,-5
2014,1113,1124,10,6,4
2014,1107,1140,16,10,6
2014,1110,1140,15,10,5
2014,1112,1140,1,10,-9
2014,1113,1140,10,10,0
2014,1124,1140,6,10,-4
2014,1107,1142,16,16,0
2014,1110,1142,15,16,-1
2014,1112,1142,1,16,-15
2014,1113,1142,10,16,-6
2014,1124,1142,6,16,-10
2014,1140,1142,10,16,-6
2014,1107,1153,16,5,11
2014,1110,1153,15,5,10
2014,1112,1153,1,5,-4
2014,1113,1153,10,5,5
2014,1124,1153,6,5,1
2014,1140,1153,10,5,5
2014,1142,1153,16,5,11
2014,1107,1157,16,16,0
2014,1110,1157,15,16,-1
2014,1112,1157,1,16,-15
2014,1113,1157,10,16,-6
2014,1124,1157,6,16,-10
2014,1140,1157,10,16,-6
2014,1142,1157,16,16,0
2014,1153,1157,5,16,-11
2014,1107,1160,16,8,8
2014,1110,1160,15,8,7
2014,1112,1160,1,8,-7
2014,1113,1160,10,8,2
2014,1124,1160,6,8,-2
2014,1140,1160,10,8,2
2014,1142,1160,16,8,8
2014,1153,1160,5,8,-3
2014,1157,1160,16,8,8
2014,1107,1163,16,7,9
2014,1110,1163,15,7,8
2014,1112,1163,1,7,-6
2014,1113,1163,10,7,3
2014,1124,1163,6,7,-1
2014,1140,1163,10,7,3
2014,1142,1163,16,7,9
2014,1153,1163,5,7,-2
2014,1157,1163,16,7,9
2014,1160,1163,8,7,1
2014,1107,1166,16,3,13
2014,1110,1166,15,3,12
2014,1112,1166,1,3,-2
2014,1113,1166,10,3,7
2014,1124,1166,6,3,3
2014,1140,1166,10,3,7
2014,1142,1166,16,3,13
2014,1153,1166,5,3,2
2014,1157,1166,16,3,13
2014,1160,1166,8,3,5
2014,1163,1166,7,3,4
2014,1107,1173,16,11,5
2014,1110,1173,15,11,4
2014,1112,1173,1,11,-10
2014,1113,1173,10,11,-1
2014,1124,1173,6,11,-5
2014,1140,1173,10,11,-1
2014,1142,1173,16,11,5
2014,1153,1173,5,11,-6
2014,1157,1173,16,11,5
2014,1160,1173,8,11,-3
2014,1163,1173,7,11,-4
2014,1166,1173,3,11,-8
2014,1107,1174,16,13,3
2014,1110,1174,15,13,2
2014,1112,1174,1,13,-12
2014,1113,1174,10,13,-3
2014,1124,1174,6,13,-7
2014,1140,1174,10,13,-3
2014,1142,1174,16,13,3
2014,1153,1174,5,13,-8
2014,1157,1174,16,13,3
2014,1160,1174,8,13,-5
2014,1163,1174,7,13,-6
2014,1166,1174,3,13,-10
2014,1173,1174,11,13,-2
2014,1107,1181,16,3,13
2014,1110,1181,15,3,12
2014,1112,1181,1,3,-2
2014,1113,1181,10,3,7
2014,1124,1181,6,3,3
2014,1140,1181,10,3,7
2014,1142,1181,16,3,13
2014,1153,1181,5,3,2
2014,1157,1181,16,3,13
2014,1160,1181,8,3,5
2014,1163,1181,7,3,4
2014,1166,1181,3,3,0
2014,1173,1181,11,3,8
2014,1174,1181,13,3,10
2014,1107,1184,16,15,1
2014,1110,1184,15,15,0
2014,1112,1184,1,15,-14
2014,1113,1184,10,15,-5
2014,1124,1184,6,15,-9
2014,1140,1184,10,15,-5
2014,1142,1184,16,15,1
2014,1153,1184,5,15,-10
2014,1157,1184,16,15,1
2014,1160,1184,8,15,-7
2014,1163,1184,7,15,-8
2014,1166,1184,3,15,-12
2014,1173,1184,11,15,-4
2014,1174,1184,13,15,-2
2014,1181,1184,3,15,-12
2014,1107,1196,16,1,15
2014,1110,1196,15,1,14
2014,1112,1196,1,1,0
2014,1113,1196,10,1,9
2014,1124,1196,6,1,5
2014,1140,1196,10,1,9
2014,1142,1196,16,1,15
2014,1153,1196,5,1,4
2014,1157,1196,16,1,15
2014,1160,1196,8,1,7
2014,1163,1196,7,1,6
2014,1166,1196,3,1,2
2014,1173,1196,11,1,10
2014,1174,1196,13,1,12
2014,1181,1196,3,1,2
2014,1184,1196,15,1,14
2014,1107,1203,16,9,7
2014,1110,1203,15,9,6
2014,1112,1203,1,9,-8
2014,1113,1203,10,9,1
2014,1124,1203,6,9,-3
2014,1140,1203,10,9,1
2014,1142,1203,16,9,7
2014,1153,1203,5,9,-4
2014,1157,1203,16,9,7
2014,1160,1203,8,9,-1
2014,1163,1203,7,9,-2
2014,1166,1203,3,9,-6
2014,1173,1203,11,9,2
2014,1174,1203,13,9,4
2014,1181,1203,3,9,-6
2014,1184,1203,15,9,6
2014,1196,1203,1,9,-8
2014,1107,1211,16,8,8
2014,1110,1211,15,8,7
2014,1112,1211,1,8,-7
2014,1113,1211,10,8,2
2014,1124,1211,6,8,-2
2014,1140,1211,10,8,2
2014,1142,1211,16,8,8
2014,1153,1211,5,8,-3
2014,1157,1211,16,8,8
2014,1160,1211,8,8,0
2014,1163,1211,7,8,-1
2014,1166,1211,3,8,-5
2014,1173,1211,11,8,3
2014,1174,1211,13,8,5
2014,1181,1211,3,8,-5
2014,1184,1211,15,8,7
2014,1196,1211,1,8,-7
2014,1203,1211,9,8,1
2014,1107,1217,16,12,4
2014,1110,1217,15,12,3
2014,1112,1217,1,12,-11
2014,1113,1217,10,12,-2
2014,1124,1217,6,12,-6
2014,1140,1217,10,12,-2
2014,1142,1217,16,12,4
2014,1153,1217,5,12,-7
2014,1157,1217,16,12,4
2014,1160,1217,8,12,-4
2014,1163,1217,7,12,-5
2014,1166,1217,3,12,-9
2014,1173,1217,11,12,-1
2014,1174,1217,13,12,1
2014,1181,1217,3,12,-9
2014,1184,1217,15,12,3
2014,1196,1217,1,12,-11
2014,1203,1217,9,12,-3
2014,1211,1217,8,12,-4
2014,1107,1234,16,11,5
2014,1110,1234,15,11,4
2014,1112,1234,1,11,-10
2014,1113,1234,10,11,-1
2014,1124,1234,6,11,-5
2014,1140,1234,10,11,-1
2014,1142,1234,16,11,5
2014,1153,1234,5,11,-6
2014,1157,1234,16,11,5
2014,1160,1234,8,11,-3
2014,1163,1234,7,11,-4
2014,1166,1234,3,11,-8
2014,1173,1234,11,11,0
2014,1174,1234,13,11,2
2014,1181,1234,3,11,-8
2014,1184,1234,15,11,4
2014,1196,1234,1,11,-10
2014,1203,1234,9,11,-2
2014,1211,1234,8,11,-3
2014,1217,1234,12,11,1
2014,1107,1235,16,3,13
2014,1110,1235,15,3,12
2014,1112,1235,1,3,-2
2014,1113,1235,10,3,7
2014,1124,1235,6,3,3
2014,1140,1235,10,3,7
2014,1142,1235,16,3,13
2014,1153,1235,5,3,2
2014,1157,1235,16,3,13
2014,1160,1235,8,3,5
2014,1163,1235,7,3,4
2014,1166,1235,3,3,0
2014,1173,1235,11,3,8
2014,1174,1235,13,3,10
2014,1181,1235,3,3,0
2014,1184,1235,15,3,12
2014,1196,1235,1,3,-2
2014,1203,1235,9,3,6
2014,1211,1235,8,3,5
2014,1217,1235,12,3,9
2014,1234,1235,11,3,8
2014,1107,1242,16,2,14
2014,1110,1242,15,2,13
2014,1112,1242,1,2,-1
2014,1113,1242,10,2,8
2014,1124,1242,6,2,4
2014,1140,1242,10,2,8
2014,1142,1242,16,2,14
2014,1153,1242,5,2,3
2014,1157,1242,16,2,14
2014,1160,1242,8,2,6
2014,1163,1242,7,2,5
2014,1166,1242,3,2,1
2014,1173,1242,11,2,9
2014,1174,1242,13,2,11
2014,1181,1242,3,2,1
2014,1184,1242,15,2,13
2014,1196,1242,1,2,-1
2014,1203,1242,9,2,7
2014,1211,1242,8,2,6
2014,1217,1242,12,2,10
2014,1234,1242,11,2,9
2014,1235,1242,3,2,1
2014,1107,1243,16,9,7
2014,1110,1243,15,9,6
2014,1112,1243,1,9,-8
2014,1113,1243,10,9,1
2014,1124,1243,6,9,-3
2014,1140,1243,10,9,1
2014,1142,1243,16,9,7
2014,1153,1243,5,9,-4
2014,1157,1243,16,9,7
2014,1160,1243,8,9,-1
2014,1163,1243,7,9,-2
2014,1166,1243,3,9,-6
2014,1173,1243,11,9,2
2014,1174,1243,13,9,4
2014,1181,1243,3,9,-6
2014,1184,1243,15,9,6
2014,1196,1243,1,9,-8
2014,1203,1243,9,9,0
2014,1211,1243,8,9,-1
2014,1217,1243,12,9,3
2014,1234,1243,11,9,2
2014,1235,1243,3,9,-6
2014,1242,1243,2,9,-7
2014,1107,1246,16,8,8
2014,1110,1246,15,8,7
2014,1112,1246,1,8,-7
2014,1113,1246,10,8,2
2014,1124,1246,6,8,-2
2014,1140,1246,10,8,2
2014,1142,1246,16,8,8
2014,1153,1246,5,8,-3
2014,1157,1246,16,8,8
2014,1160,1246,8,8,0
2014,1163,1246,7,8,-1
2014,1166,1246,3,8,-5
2014,1173,1246,11,8,3
2014,1174,1246,13,8,5
2014,1181,1246,3,8,-5
2014,1184,1246,15,8,7
2014,1196,1246,1,8,-7
2014,1203,1246,9,8,1
2014,1211,1246,8,8,0
2014,1217,1246,12,8,4
2014,1234,1246,11,8,3
2014,1235,1246,3,8,-5
2014,1242,1246,2,8,-6
2014,1243,1246,9,8,1
2014,1107,1257,16,4,12
2014,1110,1257,15,4,11
2014,1112,1257,1,4,-3
2014,1113,1257,10,4,6
2014,1124,1257,6,4,2
2014,1140,1257,10,4,6
2014,1142,1257,16,4,12
2014,1153,1257,5,4,1
2014,1157,1257,16,4,12
2014,1160,1257,8,4,4
2014,1163,1257,7,4,3
2014,1166,1257,3,4,-1
2014,1173,1257,11,4,7
2014,1174,1257,13,4,9
2014,1181,1257,3,4,-1
2014,1184,1257,15,4,11
2014,1196,1257,1,4,-3
2014,1203,1257,9,4,5
2014,1211,1257,8,4,4
2014,1217,1257,12,4,8
2014,1234,1257,11,4,7
2014,1235,1257,3,4,-1
2014,1242,1257,2,4,-2
2014,1243,1257,9,4,5
2014,1246,1257,8,4,4
2014,1107,1264,16,13,3
2014,1110,1264,15,13,2
2014,1112,1264,1,13,-12
2014,1113,1264,10,13,-3
2014,1124,1264,6,13,-7
2014,1140,1264,10,13,-3
2014,1142,1264,16,13,3
2014,1153,1264,5,13,-8
2014,1157,1264,16,13,3
2014,1160,1264,8,13,-5
2014,1163,1264,7,13,-6
2014,1166,1264,3,13,-10
2014,1173,1264,11,13,-2
2014,1174,1264,13,13,0
2014,1181,1264,3,13,-10
2014,1184,1264,15,13,2
2014,1196,1264,1,13,-12
2014,1203,1264,9,13,-4
2014,1211,1264,8,13,-5
2014,1217,1264,12,13,-1
2014,1234,1264,11,13,-2
2014,1235,1264,3,13,-10
2014,1242,1264,2,13,-11
2014,1243,1264,9,13,-4
2014,1246,1264,8,13,-5
2014,1257,1264,4,13,-9
2014,1107,1269,16,6,10
2014,1110,1269,15,6,9
2014,1112,1269,1,6,-5
2014,1113,1269,10,6,4
2014,1124,1269,6,6,0
2014,1140,1269,10,6,4
2014,1142,1269,16,6,10
2014,1153,1269,5,6,-1
2014,1157,1269,16,6,10
2014,1160,1269,8,6,2
2014,1163,1269,7,6,1
2014,1166,1269,3,6,-3
2014,1173,1269,11,6,5
2014,1174,1269,13,6,7
2014,1181,1269,3,6,-3
2014,1184,1269,15,6,9
2014,1196,1269,1,6,-5
2014,1203,1269,9,6,3
2014,1211,1269,8,6,2
2014,1217,1269,12,6,6
2014,1234,1269,11,6,5
2014,1235,1269,3,6,-3
2014,1242,1269,2,6,-4
2014,1243,1269,9,6,3
2014,1246,1269,8,6,2
2014,1257,1269,4,6,-2
2014,1264,1269,13,6,7
2014,1107,1272,16,8,8
2014,1110,1272,15,8,7
2014,1112,1272,1,8,-7
2014,1113,1272,10,8,2
2014,1124,1272,6,8,-2
2014,1140,1272,10,8,2
2014,1142,1272,16,8,8
2014,1153,1272,5,8,-3
2014,1157,1272,16,8,8
2014,1160,1272,8,8,0
2014,1163,1272,7,8,-1
2014,1166,1272,3,8,-5
2014,1173,1272,11,8,3
2014,1174,1272,13,8,5
2014,1181,1272,3,8,-5
2014,1184,1272,15,8,7
2014,1196,1272,1,8,-7
2014,1203,1272,9,8,1
2014,1211,1272,8,8,0
2014,1217,1272,12,8,4
2014,1234,1272,11,8,3
2014,1235,1272,3,8,-5
2014,1242,1272,2,8,-6
2014,1243,1272,9,8,1
2014,1246,1272,8,8,0
2014,1257,1272,4,8,-4
2014,1264,1272,13,8,5
2014,1269,1272,6,8,-2
2014,1107,1273,16,14,2
2014,1110,1273,15,14,1
2014,1112,1273,1,14,-13
2014,1113,1273,10,14,-4
2014,1124,1273,6,14,-8
2014,1140,1273,10,14,-4
2014,1142,1273,16,14,2
2014,1153,1273,5,14,-9
2014,1157,1273,16,14,2
2014,1160,1273,8,14,-6
2014,1163,1273,7,14,-7
2014,1166,1273,3,14,-11
2014,1173,1273,11,14,-3
2014,1174,1273,13,14,-1
2014,1181,1273,3,14,-11
2014,1184,1273,15,14,1
2014,1196,1273,1,14,-13
2014,1203,1273,9,14,-5
2014,1211,1273,8,14,-6
2014,1217,1273,12,14,-2
2014,1234,1273,11,14,-3
2014,1235,1273,3,14,-11
2014,1242,1273,2,14,-12
2014,1243,1273,9,14,-5
2014,1246,1273,8,14,-6
2014,1257,1273,4,14,-10
2014,1264,1273,13,14,-1
2014,1269,1273,6,14,-8
2014,1272,1273,8,14,-6
2014,1107,1276,16,2,14
2014,1110,1276,15,2,13
2014,1112,1276,1,2,-1
2014,1113,1276,10,2,8
2014,1124,1276,6,2,4
2014,1140,1276,10,2,8
2014,1142,1276,16,2,14
2014,1153,1276,5,2,3
2014,1157,1276,16,2,14
2014,1160,1276,8,2,6
2014,1163,1276,7,2,5
2014,1166,1276,3,2,1
2014,1173,1276,11,2,9
2014,1174,1276,13,2,11
2014,1181,1276,3,2,1
2014,1184,1276,15,2,13
2014,1196,1276,1,2,-1
2014,1203,1276,9,2,7
2014,1211,1276,8,2,6
2014,1217,1276,12,2,10
2014,1234,1276,11,2,9
2014,1235,1276,3,2,1
2014,1242,1276,2,2,0
2014,1243,1276,9,2,7
2014,1246,1276,8,2,6
2014,1257,1276,4,2,2
2014,1264,1276,13,2,11
2014,1269,1276,6,2,4
2014,1272,1276,8,2,6
2014,1273,1276,14,2,12
2014,1107,1277,16,4,12
2014,1110,1277,15,4,11
2014,1112,1277,1,4,-3
2014,1113,1277,10,4,6
2014,1124,1277,6,4,2
2014,1140,1277,10,4,6
2014,1142,1277,16,4,12
2014,1153,1277,5,4,1
2014,1157,1277,16,4,12
2014,1160,1277,8,4,4
2014,1163,1277,7,4,3
2014,1166,1277,3,4,-1
2014,1173,1277,11,4,7
2014,1174,1277,13,4,9
2014,1181,1277,3,4,-1
2014,1184,1277,15,4,11
2014,1196,1277,1,4,-3
2014,1203,1277,9,4,5
2014,1211,1277,8,4,4
2014,1217,1277,12,4,8
2014,1234,1277,11,4,7
2014,1235,1277,3,4,-1
2014,1242,1277,2,4,-2
2014,1243,1277,9,4,5
2014,1246,1277,8,4,4
2014,1257,1277,4,4,0
2014,1264,1277,13,4,9
2014,1269,1277,6,4,2
2014,1272,1277,8,4,4
2014,1273,1277,14,4,10
2014,1276,1277,2,4,-2
2014,1107,1291,16,16,0
2014,1110,1291,15,16,-1
2014,1112,1291,1,16,-15
2014,1113,1291,10,16,-6
2014,1124,1291,6,16,-10
2014,1140,1291,10,16,-6
2014,1142,1291,16,16,0
2014,1153,1291,5,16,-11
2014,1157,1291,16,16,0
2014,1160,1291,8,16,-8
2014,1163,1291,7,16,-9
2014,1166,1291,3,16,-13
2014,1173,1291,11,16,-5
2014,1174,1291,13,16,-3
2014,1181,1291,3,16,-13
2014,1184,1291,15,16,-1
2014,1196,1291,1,16,-15
2014,1203,1291,9,16,-7
2014,1211,1291,8,16,-8
2014,1217,1291,12,16,-4
2014,1234,1291,11,16,-5
2014,1235,1291,3,16,-13
2014,1242,1291,2,16,-14
2014,1243,1291,9,16,-7
2014,1246,1291,8,16,-8
2014,1257,1291,4,16,-12
2014,1264,1291,13,16,-3
2014,1269,1291,6,16,-10
2014,1272,1291,8,16,-8
2014,1273,1291,14,16,-2
2014,1276,1291,2,16,-14
2014,1277,1291,4,16,-12
2014,1107,1295,16,12,4
2014,1110,1295,15,12,3
2014,1112,1295,1,12,-11
2014,1113,1295,10,12,-2
2014,1124,1295,6,12,-6
2014,1140,1295,10,12,-2
2014,1142,1295,16,12,4
2014,1153,1295,5,12,-7
2014,1157,1295,16,12,4
2014,1160,1295,8,12,-4
2014,1163,1295,7,12,-5
2014,1166,1295,3,12,-9
2014,1173,1295,11,12,-1
2014,1174,1295,13,12,1
2014,1181,1295,3,12,-9
2014,1184,1295,15,12,3
2014,1196,1295,1,12,-11
2014,1203,1295,9,12,-3
2014,1211,1295,8,12,-4
2014,1217,1295,12,12,0
2014,1234,1295,11,12,-1
2014,1235,1295,3,12,-9
2014,1242,1295,2,12,-10
2014,1243,1295,9,12,-3
2014,1246,1295,8,12,-4
2014,1257,1295,4,12,-8
2014,1264,1295,13,12,1
2014,1269,1295,6,12,-6
2014,1272,1295,8,12,-4
2014,1273,1295,14,12,2
2014,1276,1295,2,12,-10
2014,1277,1295,4,12,-8
2014,1291,1295,16,12,4
2014,1107,1300,16,14,2
2014,1110,1300,15,14,1
2014,1112,1300,1,14,-13
2014,1113,1300,10,14,-4
2014,1124,1300,6,14,-8
2014,1140,1300,10,14,-4
2014,1142,1300,16,14,2
2014,1153,1300,5,14,-9
2014,1157,1300,16,14,2
2014,1160,1300,8,14,-6
2014,1163,1300,7,14,-7
2014,1166,1300,3,14,-11
2014,1173,1300,11,14,-3
2014,1174,1300,13,14,-1
2014,1181,1300,3,14,-11
2014,1184,1300,15,14,1
2014,1196,1300,1,14,-13
2014,1203,1300,9,14,-5
2014,1211,1300,8,14,-6
2014,1217,1300,12,14,-2
2014,1234,1300,11,14,-3
2014,1235,1300,3,14,-11
2014,1242,1300,2,14,-12
2014,1243,1300,9,14,-5
2014,1246,1300,8,14,-6
2014,1257,1300,4,14,-10
2014,1264,1300,13,14,-1
2014,1269,1300,6,14,-8
2014,1272,1300,8,14,-6
2014,1273,1300,14,14,0
2014,1276,1300,2,14,-12
2014,1277,1300,4,14,-10
2014,1291,1300,16,14,2
2014,1295,1300,12,14,-2
2014,1107,1301,16,12,4
2014,1110,1301,15,12,3
2014,1112,1301,1,12,-11
2014,1113,1301,10,12,-2
2014,1124,1301,6,12,-6
2014,1140,1301,10,12,-2
2014,1142,1301,16,12,4
2014,1153,1301,5,12,-7
2014,1157,1301,16,12,4
2014,1160,1301,8,12,-4
2014,1163,1301,7,12,-5
2014,1166,1301,3,12,-9
2014,1173,1301,11,12,-1
2014,1174,1301,13,12,1
2014,1181,1301,3,12,-9
2014,1184,1301,15,12,3
2014,1196,1301,1,12,-11
2014,1203,1301,9,12,-3
2014,1211,1301,8,12,-4
2014,1217,1301,12,12,0
2014,1234,1301,11,12,-1
2014,1235,1301,3,12,-9
2014,1242,1301,2,12,-10
2014,1243,1301,9,12,-3
2014,1246,1301,8,12,-4
2014,1257,1301,4,12,-8
2014,1264,1301,13,12,1
2014,1269,1301,6,12,-6
2014,1272,1301,8,12,-4
2014,1273,1301,14,12,2
2014,1276,1301,2,12,-10
2014,1277,1301,4,12,-8
2014,1291,1301,16,12,4
2014,1295,1301,12,12,0
2014,1300,1301,14,12,2
2014,1107,1304,16,11,5
2014,1110,1304,15,11,4
2014,1112,1304,1,11,-10
2014,1113,1304,10,11,-1
2014,1124,1304,6,11,-5
2014,1140,1304,10,11,-1
2014,1142,1304,16,11,5
2014,1153,1304,5,11,-6
2014,1157,1304,16,11,5
2014,1160,1304,8,11,-3
2014,1163,1304,7,11,-4
2014,1166,1304,3,11,-8
2014,1173,1304,11,11,0
2014,1174,1304,13,11,2
2014,1181,1304,3,11,-8
2014,1184,1304,15,11,4
2014,1196,1304,1,11,-10
2014,1203,1304,9,11,-2
2014,1211,1304,8,11,-3
2014,1217,1304,12,11,1
2014,1234,1304,11,11,0
2014,1235,1304,3,11,-8
2014,1242,1304,2,11,-9
2014,1243,1304,9,11,-2
2014,1246,1304,8,11,-3
2014,1257,1304,4,11,-7
2014,1264,1304,13,11,2
2014,1269,1304,6,11,-5
2014,1272,1304,8,11,-3
2014,1273,1304,14,11,3
2014,1276,1304,2,11,-9
2014,1277,1304,4,11,-7
2014,1291,1304,16,11,5
2014,1295,1304,12,11,1
2014,1300,1304,14,11,3
2014,1301,1304,12,11,1
2014,1107,1307,16,7,9
2014,1110,1307,15,7,8
2014,1112,1307,1,7,-6
2014,1113,1307,10,7,3
2014,1124,1307,6,7,-1
2014,1140,1307,10,7,3
2014,1142,1307,16,7,9
2014,1153,1307,5,7,-2
2014,1157,1307,16,7,9
2014,1160,1307,8,7,1
2014,1163,1307,7,7,0
2014,1166,1307,3,7,-4
2014,1173,1307,11,7,4
2014,1174,1307,13,7,6
2014,1181,1307,3,7,-4
2014,1184,1307,15,7,8
2014,1196,1307,1,7,-6
2014,1203,1307,9,7,2
2014,1211,1307,8,7,1
2014,1217,1307,12,7,5
2014,1234,1307,11,7,4
2014,1235,1307,3,7,-4
2014,1242,1307,2,7,-5
2014,1243,1307,9,7,2
2014,1246,1307,8,7,1
2014,1257,1307,4,7,-3
2014,1264,1307,13,7,6
2014,1269,1307,6,7,-1
2014,1272,1307,8,7,1
2014,1273,1307,14,7,7
2014,1276,1307,2,7,-5
2014,1277,1307,4,7,-3
2014,1291,1307,16,7,9
2014,1295,1307,12,7,5
2014,1300,1307,14,7,7
2014,1301,1307,12,7,5
2014,1304,1307,11,7,4
2014,1107,1308,16,13,3
2014,1110,1308,15,13,2
2014,1112,1308,1,13,-12
2014,1113,1308,10,13,-3
2014,1124,1308,6,13,-7
2014,1140,1308,10,13,-3
2014,1142,1308,16,13,3
2014,1153,1308,5,13,-8
2014,1157,1308,16,13,3
2014,1160,1308,8,13,-5
2014,1163,1308,7,13,-6
2014,1166,1308,3,13,-10
2014,1173,1308,11,13,-2
2014,1174,1308,13,13,0
2014,1181,1308,3,13,-10
2014,1184,1308,15,13,2
2014,1196,1308,1,13,-12
2014,1203,1308,9,13,-4
2014,1211,1308,8,13,-5
2014,1217,1308,12,13,-1
2014,1234,1308,11,13,-2
2014,1235,1308,3,13,-10
2014,1242,1308,2,13,-11
2014,1243,1308,9,13,-4
2014,1246,1308,8,13,-5
2014,1257,1308,4,13,-9
2014,1264,1308,13,13,0
2014,1269,1308,6,13,-7
2014,1272,1308,8,13,-5
2014,1273,1308,14,13,1
2014,1276,1308,2,13,-11
2014,1277,1308,4,13,-9
2014,1291,1308,16,13,3
2014,1295,1308,12,13,-1
2014,1300,1308,14,13,1
2014,1301,1308,12,13,-1
2014,1304,1308,11,13,-2
2014,1307,1308,7,13,-6
2014,1107,1314,16,6,10
2014,1110,1314,15,6,9
2014,1112,1314,1,6,-5
2014,1113,1314,10,6,4
2014,1124,1314,6,6,0
2014,1140,1314,10,6,4
2014,1142,1314,16,6,10
2014,1153,1314,5,6,-1
2014,1157,1314,16,6,10
2014,1160,1314,8,6,2
2014,1163,1314,7,6,1
2014,1166,1314,3,6,-3
2014,1173,1314,11,6,5
2014,1174,1314,13,6,7
2014,1181,1314,3,6,-3
2014,1184,1314,15,6,9
2014,1196,1314,1,6,-5
2014,1203,1314,9,6,3
2014,1211,1314,8,6,2
2014,1217,1314,12,6,6
2014,1234,1314,11,6,5
2014,1235,1314,3,6,-3
2014,1242,1314,2,6,-4
2014,1243,1314,9,6,3
2014,1246,1314,8,6,2
2014,1257,1314,4,6,-2
2014,1264,1314,13,6,7
2014,1269,1314,6,6,0
2014,1272,1314,8,6,2
2014,1273,1314,14,6,8
2014,1276,1314,2,6,-4
2014,1277,1314,4,6,-2
2014,1291,1314,16,6,10
2014,1295,1314,12,6,6
2014,1300,1314,14,6,8
2014,1301,1314,12,6,6
2014,1304,1314,11,6,5
2014,1307,1314,7,6,1
2014,1308,1314,13,6,7
2014,1107,1326,16,6,10
2014,1110,1326,15,6,9
2014,1112,1326,1,6,-5
2014,1113,1326,10,6,4
2014,1124,1326,6,6,0
2014,1140,1326,10,6,4
2014,1142,1326,16,6,10
2014,1153,1326,5,6,-1
2014,1157,1326,16,6,10
2014,1160,1326,8,6,2
2014,1163,1326,7,6,1
2014,1166,1326,3,6,-3
2014,1173,1326,11,6,5
2014,1174,1326,13,6,7
2014,1181,1326,3,6,-3
2014,1184,1326,15,6,9
2014,1196,1326,1,6,-5
2014,1203,1326,9,6,3
2014,1211,1326,8,6,2
2014,1217,1326,12,6,6
2014,1234,1326,11,6,5
2014,1235,1326,3,6,-3
2014,1242,1326,2,6,-4
2014,1243,1326,9,6,3
2014,1246,1326,8,6,2
2014,1257,1326,4,6,-2
2014,1264,1326,13,6,7
2014,1269,1326,6,6,0
2014,1272,1326,8,6,2
2014,1273,1326,14,6,8
2014,1276,1326,2,6,-4
2014,1277,1326,4,6,-2
2014,1291,1326,16,6,10
2014,1295,1326,12,6,6
2014,1300,1326,14,6,8
2014,1301,1326,12,6,6
2014,1304,1326,11,6,5
2014,1307,1326,7,6,1
2014,1308,1326,13,6,7
2014,1314,1326,6,6,0
2014,1107,1328,16,5,11
2014,1110,1328,15,5,10
2014,1112,1328,1,5,-4
2014,1113,1328,10,5,5
2014,1124,1328,6,5,1
2014,1140,1328,10,5,5
2014,1142,1328,16,5,11
2014,1153,1328,5,5,0
2014,1157,1328,16,5,11
2014,1160,1328,8,5,3
2014,1163,1328,7,5,2
2014,1166,1328,3,5,-2
2014,1173,1328,11,5,6
2014,1174,1328,13,5,8
2014,1181,1328,3,5,-2
2014,1184,1328,15,5,10
2014,1196,1328,1,5,-4
2014,1203,1328,9,5,4
2014,1211,1328,8,5,3
2014,1217,1328,12,5,7
2014,1234,1328,11,5,6
2014,1235,1328,3,5,-2
2014,1242,1328,2,5,-3
2014,1243,1328,9,5,4
2014,1246,1328,8,5,3
2014,1257,1328,4,5,-1
2014,1264,1328,13,5,8
2014,1269,1328,6,5,1
2014,1272,1328,8,5,3
2014,1273,1328,14,5,9
2014,1276,1328,2,5,-3
2014,1277,1328,4,5,-1
2014,1291,1328,16,5,11
2014,1295,1328,12,5,7
2014,1300,1328,14,5,9
2014,1301,1328,12,5,7
2014,1304,1328,11,5,6
2014,1307,1328,7,5,2
2014,1308,1328,13,5,8
2014,1314,1328,6,5,1
2014,1326,1328,6,5,1
2014,1107,1329,16,9,7
2014,1110,1329,15,9,6
2014,1112,1329,1,9,-8
2014,1113,1329,10,9,1
2014,1124,1329,6,9,-3
2014,1140,1329,10,9,1
2014,1142,1329,16,9,7
2014,1153,1329,5,9,-4
2014,1157,1329,16,9,7
2014,1160,1329,8,9,-1
2014,1163,1329,7,9,-2
2014,1166,1329,3,9,-6
2014,1173,1329,11,9,2
2014,1174,1329,13,9,4
2014,1181,1329,3,9,-6
2014,1184,1329,15,9,6
2014,1196,1329,1,9,-8
2014,1203,1329,9,9,0
2014,1211,1329,8,9,-1
2014,1217,1329,12,9,3
2014,1234,1329,11,9,2
2014,1235,1329,3,9,-6
2014,1242,1329,2,9,-7
2014,1243,1329,9,9,0
2014,1246,1329,8,9,-1
2014,1257,1329,4,9,-5
2014,1264,1329,13,9,4
2014,1269,1329,6,9,-3
2014,1272,1329,8,9,-1
2014,1273,1329,14,9,5
2014,1276,1329,2,9,-7
2014,1277,1329,4,9,-5
2014,1291,1329,16,9,7
2014,1295,1329,12,9,3
2014,1300,1329,14,9,5
2014,1301,1329,12,9,3
2014,1304,1329,11,9,2
2014,1307,1329,7,9,-2
2014,1308,1329,13,9,4
2014,1314,1329,6,9,-3
2014,1326,1329,6,9,-3
2014,1328,1329,5,9,-4
2014,1107,1332,16,7,9
2014,1110,1332,15,7,8
2014,1112,1332,1,7,-6
2014,1113,1332,10,7,3
2014,1124,1332,6,7,-1
2014,1140,1332,10,7,3
2014,1142,1332,16,7,9
2014,1153,1332,5,7,-2
2014,1157,1332,16,7,9
2014,1160,1332,8,7,1
2014,1163,1332,7,7,0
2014,1166,1332,3,7,-4
2014,1173,1332,11,7,4
2014,1174,1332,13,7,6
2014,1181,1332,3,7,-4
2014,1184,1332,15,7,8
2014,1196,1332,1,7,-6
2014,1203,1332,9,7,2
2014,1211,1332,8,7,1
2014,1217,1332,12,7,5
2014,1234,1332,11,7,4
2014,1235,1332,3,7,-4
2014,1242,1332,2,7,-5
2014,1243,1332,9,7,2
2014,1246,1332,8,7,1
2014,1257,1332,4,7,-3
2014,1264,1332,13,7,6
2014,1269,1332,6,7,-1
2014,1272,1332,8,7,1
2014,1273,1332,14,7,7
2014,1276,1332,2,7,-5
2014,1277,1332,4,7,-3
2014,1291,1332,16,7,9
2014,1295,1332,12,7,5
2014,1300,1332,14,7,7
2014,1301,1332,12,7,5
2014,1304,1332,11,7,4
2014,1307,1332,7,7,0
2014,1308,1332,13,7,6
2014,1314,1332,6,7,-1
2014,1326,1332,6,7,-1
2014,1328,1332,5,7,-2
2014,1329,1332,9,7,2
2014,1107,1338,16,9,7
2014,1110,1338,15,9,6
2014,1112,1338,1,9,-8
2014,1113,1338,10,9,1
2014,1124,1338,6,9,-3
2014,1140,1338,10,9,1
2014,1142,1338,16,9,7
2014,1153,1338,5,9,-4
2014,1157,1338,16,9,7
2014,1160,1338,8,9,-1
2014,1163,1338,7,9,-2
2014,1166,1338,3,9,-6
2014,1173,1338,11,9,2
2014,1174,1338,13,9,4
2014,1181,1338,3,9,-6
2014,1184,1338,15,9,6
2014,1196,1338,1,9,-8
2014,1203,1338,9,9,0
2014,1211,1338,8,9,-1
2014,1217,1338,12,9,3
2014,1234,1338,11,9,2
2014,1235,1338,3,9,-6
2014,1242,1338,2,9,-7
2014,1243,1338,9,9,0
2014,1246,1338,8,9,-1
2014,1257,1338,4,9,-5
2014,1264,1338,13,9,4
2014,1269,1338,6,9,-3
2014,1272,1338,8,9,-1
2014,1273,1338,14,9,5
2014,1276,1338,2,9,-7
2014,1277,1338,4,9,-5
2014,1291,1338,16,9,7
2014,1295,1338,12,9,3
2014,1300,1338,14,9,5
2014,1301,1338,12,9,3
2014,1304,1338,11,9,2
2014,1307,1338,7,9,-2
2014,1308,1338,13,9,4
2014,1314,1338,6,9,-3
2014,1326,1338,6,9,-3
2014,1328,1338,5,9,-4
2014,1329,1338,9,9,0
2014,1332,1338,7,9,-2
2014,1107,1344,16,11,5
2014,1110,1344,15,11,4
2014,1112,1344,1,11,-10
2014,1113,1344,10,11,-1
2014,1124,1344,6,11,-5
2014,1140,1344,10,11,-1
2014,1142,1344,16,11,5
2014,1153,1344,5,11,-6
2014,1157,1344,16,11,5
2014,1160,1344,8,11,-3
2014,1163,1344,7,11,-4
2014,1166,1344,3,11,-8
2014,1173,1344,11,11,0
2014,1174,1344,13,11,2
2014,1181,1344,3,11,-8
2014,1184,1344,15,11,4
2014,1196,1344,1,11,-10
2014,1203,1344,9,11,-2
2014,1211,1344,8,11,-3
2014,1217,1344,12,11,1
2014,1234,1344,11,11,0
2014,1235,1344,3,11,-8
2014,1242,1344,2,11,-9
2014,1243,1344,9,11,-2
2014,1246,1344,8,11,-3
2014,1257,1344,4,11,-7
2014,1264,1344,13,11,2
2014,1269,1344,6,11,-5
2014,1272,1344,8,11,-3
2014,1273,1344,14,11,3
2014,1276,1344,2,11,-9
2014,1277,1344,4,11,-7
2014,1291,1344,16,11,5
2014,1295,1344,12,11,1
2014,1300,1344,14,11,3
2014,1301,1344,12,11,1
2014,1304,1344,11,11,0
2014,1307,1344,7,11,-4
2014,1308,1344,13,11,2
2014,1314,1344,6,11,-5
2014,1326,1344,6,11,-5
2014,1328,1344,5,11,-6
2014,1329,1344,9,11,-2
2014,1332,1344,7,11,-4
2014,1338,1344,9,11,-2
2014,1107,1361,16,4,12
2014,1110,1361,15,4,11
2014,1112,1361,1,4,-3
2014,1113,1361,10,4,6
2014,1124,1361,6,4,2
2014,1140,1361,10,4,6
2014,1142,1361,16,4,12
2014,1153,1361,5,4,1
2014,1157,1361,16,4,12
2014,1160,1361,8,4,4
2014,1163,1361,7,4,3
2014,1166,1361,3,4,-1
2014,1173,1361,11,4,7
2014,1174,1361,13,4,9
2014,1181,1361,3,4,-1
2014,1184,1361,15,4,11
2014,1196,1361,1,4,-3
2014,1203,1361,9,4,5
2014,1211,1361,8,4,4
2014,1217,1361,12,4,8
2014,1234,1361,11,4,7
2014,1235,1361,3,4,-1
2014,1242,1361,2,4,-2
2014,1243,1361,9,4,5
2014,1246,1361,8,4,4
2014,1257,1361,4,4,0
2014,1264,1361,13,4,9
2014,1269,1361,6,4,2
2014,1272,1361,8,4,4
2014,1273,1361,14,4,10
2014,1276,1361,2,4,-2
2014,1277,1361,4,4,0
2014,1291,1361,16,4,12
2014,1295,1361,12,4,8
2014,1300,1361,14,4,10
2014,1301,1361,12,4,8
2014,1304,1361,11,4,7
2014,1307,1361,7,4,3
2014,1308,1361,13,4,9
2014,1314,1361,6,4,2
2014,1326,1361,6,4,2
2014,1328,1361,5,4,1
2014,1329,1361,9,4,5
2014,1332,1361,7,4,3
2014,1338,1361,9,4,5
2014,1344,1361,11,4,7
2014,1107,1372,16,12,4
2014,1110,1372,15,12,3
2014,1112,1372,1,12,-11
2014,1113,1372,10,12,-2
2014,1124,1372,6,12,-6
2014,1140,1372,10,12,-2
2014,1142,1372,16,12,4
2014,1153,1372,5,12,-7
2014,1157,1372,16,12,4
2014,1160,1372,8,12,-4
2014,1163,1372,7,12,-5
2014,1166,1372,3,12,-9
2014,1173,1372,11,12,-1
2014,1174,1372,13,12,1
2014,1181,1372,3,12,-9
2014,1184,1372,15,12,3
2014,1196,1372,1,12,-11
2014,1203,1372,9,12,-3
2014,1211,1372,8,12,-4
2014,1217,1372,12,12,0
2014,1234,1372,11,12,-1
2014,1235,1372,3,12,-9
2014,1242,1372,2,12,-10
2014,1243,1372,9,12,-3
2014,1246,1372,8,12,-4
2014,1257,1372,4,12,-8
2014,1264,1372,13,12,1
2014,1269,1372,6,12,-6
2014,1272,1372,8,12,-4
2014,1273,1372,14,12,2
2014,1276,1372,2,12,-10
2014,1277,1372,4,12,-8
2014,1291,1372,16,12,4
2014,1295,1372,12,12,0
2014,1300,1372,14,12,2
2014,1301,1372,12,12,0
2014,1304,1372,11,12,-1
2014,1307,1372,7,12,-5
2014,1308,1372,13,12,1
2014,1314,1372,6,12,-6
2014,1326,1372,6,12,-6
2014,1328,1372,5,12,-7
2014,1329,1372,9,12,-3
2014,1332,1372,7,12,-5
2014,1338,1372,9,12,-3
2014,1344,1372,11,12,-1
2014,1361,1372,4,12,-8
2014,1107,1386,16,10,6
2014,1110,1386,15,10,5
2014,1112,1386,1,10,-9
2014,1113,1386,10,10,0
2014,1124,1386,6,10,-4
2014,1140,1386,10,10,0
2014,1142,1386,16,10,6
2014,1153,1386,5,10,-5
2014,1157,1386,16,10,6
2014,1160,1386,8,10,-2
2014,1163,1386,7,10,-3
2014,1166,1386,3,10,-7
2014,1173,1386,11,10,1
2014,1174,1386,13,10,3
2014,1181,1386,3,10,-7
2014,1184,1386,15,10,5
2014,1196,1386,1,10,-9
2014,1203,1386,9,10,-1
2014,1211,1386,8,10,-2
2014,1217,1386,12,10,2
2014,1234,1386,11,10,1
2014,1235,1386,3,10,-7
2014,1242,1386,2,10,-8
2014,1243,1386,9,10,-1
2014,1246,1386,8,10,-2
2014,1257,1386,4,10,-6
2014,1264,1386,13,10,3
2014,1269,1386,6,10,-4
2014,1272,1386,8,10,-2
2014,1273,1386,14,10,4
2014,1276,1386,2,10,-8
2014,1277,1386,4,10,-6
2014,1291,1386,16,10,6
2014,1295,1386,12,10,2
2014,1300,1386,14,10,4
2014,1301,1386,12,10,2
2014,1304,1386,11,10,1
2014,1307,1386,7,10,-3
2014,1308,1386,13,10,3
2014,1314,1386,6,10,-4
2014,1326,1386,6,10,-4
2014,1328,1386,5,10,-5
2014,1329,1386,9,10,-1
2014,1332,1386,7,10,-3
2014,1338,1386,9,10,-1
2014,1344,1386,11,10,1
2014,1361,1386,4,10,-6
2014,1372,1386,12,10,2
2014,1107,1387,16,5,11
2014,1110,1387,15,5,10
2014,1112,1387,1,5,-4
2014,1113,1387,10,5,5
2014,1124,1387,6,5,1
2014,1140,1387,10,5,5
2014,1142,1387,16,5,11
2014,1153,1387,5,5,0
2014,1157,1387,16,5,11
2014,1160,1387,8,5,3
2014,1163,1387,7,5,2
2014,1166,1387,3,5,-2
2014,1173,1387,11,5,6
2014,1174,1387,13,5,8
2014,1181,1387,3,5,-2
2014,1184,1387,15,5,10
2014,1196,1387,1,5,-4
2014,1203,1387,9,5,4
2014,1211,1387,8,5,3
2014,1217,1387,12,5,7
2014,1234,1387,11,5,6
2014,1235,1387,3,5,-2
2014,1242,1387,2,5,-3
2014,1243,1387,9,5,4
2014,1246,1387,8,5,3
2014,1257,1387,4,5,-1
2014,1264,1387,13,5,8
2014,1269,1387,6,5,1
2014,1272,1387,8,5,3
2014,1273,1387,14,5,9
2014,1276,1387,2,5,-3
2014,1277,1387,4,5,-1
2014,1291,1387,16,5,11
2014,1295,1387,12,5,7
2014,1300,1387,14,5,9
2014,1301,1387,12,5,7
2014,1304,1387,11,5,6
2014,1307,1387,7,5,2
2014,1308,1387,13,5,8
2014,1314,1387,6,5,1
2014,1326,1387,6,5,1
2014,1328,1387,5,5,0
2014,1329,1387,9,5,4
2014,1332,1387,7,5,2
2014,1338,1387,9,5,4
2014,1344,1387,11,5,6
2014,1361,1387,4,5,-1
2014,1372,1387,12,5,7
2014,1386,1387,10,5,5
2014,1107,1390,16,10,6
2014,1110,1390,15,10,5
2014,1112,1390,1,10,-9
2014,1113,1390,10,10,0
2014,1124,1390,6,10,-4
2014,1140,1390,10,10,0
2014,1142,1390,16,10,6
2014,1153,1390,5,10,-5
2014,1157,1390,16,10,6
2014,1160,1390,8,10,-2
2014,1163,1390,7,10,-3
2014,1166,1390,3,10,-7
2014,1173,1390,11,10,1
2014,1174,1390,13,10,3
2014,1181,1390,3,10,-7
2014,1184,1390,15,10,5
2014,1196,1390,1,10,-9
2014,1203,1390,9,10,-1
2014,1211,1390,8,10,-2
2014,1217,1390,12,10,2
2014,1234,1390,11,10,1
2014,1235,1390,3,10,-7
2014,1242,1390,2,10,-8
2014,1243,1390,9,10,-1
2014,1246,1390,8,10,-2
2014,1257,1390,4,10,-6
2014,1264,1390,13,10,3
2014,1269,1390,6,10,-4
2014,1272,1390,8,10,-2
2014,1273,1390,14,10,4
2014,1276,1390,2,10,-8
2014,1277,1390,4,10,-6
2014,1291,1390,16,10,6
2014,1295,1390,12,10,2
2014,1300,1390,14,10,4
2014,1301,1390,12,10,2
2014,1304,1390,11,10,1
2014,1307,1390,7,10,-3
2014,1308,1390,13,10,3
2014,1314,1390,6,10,-4
2014,1326,1390,6,10,-4
2014,1328,1390,5,10,-5
2014,1329,1390,9,10,-1
2014,1332,1390,7,10,-3
2014,1338,1390,9,10,-1
2014,1344,1390,11,10,1
2014,1361,1390,4,10,-6
2014,1372,1390,12,10,2
2014,1386,1390,10,10,0
2014,1387,1390,5,10,-5
2014,1107,1393,16,3,13
2014,1110,1393,15,3,12
2014,1112,1393,1,3,-2
2014,1113,1393,10,3,7
2014,1124,1393,6,3,3
2014,1140,1393,10,3,7
2014,1142,1393,16,3,13
2014,1153,1393,5,3,2
2014,1157,1393,16,3,13
2014,1160,1393,8,3,5
2014,1163,1393,7,3,4
2014,1166,1393,3,3,0
2014,1173,1393,11,3,8
2014,1174,1393,13,3,10
2014,1181,1393,3,3,0
2014,1184,1393,15,3,12
2014,1196,1393,1,3,-2
2014,1203,1393,9,3,6
2014,1211,1393,8,3,5
2014,1217,1393,12,3,9
2014,1234,1393,11,3,8
2014,1235,1393,3,3,0
2014,1242,1393,2,3,-1
2014,1243,1393,9,3,6
2014,1246,1393,8,3,5
2014,1257,1393,4,3,1
2014,1264,1393,13,3,10
2014,1269,1393,6,3,3
2014,1272,1393,8,3,5
2014,1273,1393,14,3,11
2014,1276,1393,2,3,-1
2014,1277,1393,4,3,1
2014,1291,1393,16,3,13
2014,1295,1393,12,3,9
2014,1300,1393,14,3,11
2014,1301,1393,12,3,9
2014,1304,1393,11,3,8
2014,1307,1393,7,3,4
2014,1308,1393,13,3,10
2014,1314,1393,6,3,3
2014,1326,1393,6,3,3
2014,1328,1393,5,3,2
2014,1329,1393,9,3,6
2014,1332,1393,7,3,4
2014,1338,1393,9,3,6
2014,1344,1393,11,3,8
2014,1361,1393,4,3,1
2014,1372,1393,12,3,9
2014,1386,1393,10,3,7
2014,1387,1393,5,3,2
2014,1390,1393,10,3,7
2014,1107,1397,16,11,5
2014,1110,1397,15,11,4
2014,1112,1397,1,11,-10
2014,1113,1397,10,11,-1
2014,1124,1397,6,11,-5
2014,1140,1397,10,11,-1
2014,1142,1397,16,11,5
2014,1153,1397,5,11,-6
2014,1157,1397,16,11,5
2014,1160,1397,8,11,-3
2014,1163,1397,7,11,-4
2014,1166,1397,3,11,-8
2014,1173,1397,11,11,0
2014,1174,1397,13,11,2
2014,1181,1397,3,11,-8
2014,1184,1397,15,11,4
2014,1196,1397,1,11,-10
2014,1203,1397,9,11,-2
2014,1211,1397,8,11,-3
2014,1217,1397,12,11,1
2014,1234,1397,11,11,0
2014,1235,1397,3,11,-8
2014,1242,1397,2,11,-9
2014,1243,1397,9,11,-2
2014,1246,1397,8,11,-3
2014,1257,1397,4,11,-7
2014,1264,1397,13,11,2
2014,1269,1397,6,11,-5
2014,1272,1397,8,11,-3
2014,1273,1397,14,11,3
2014,1276,1397,2,11,-9
2014,1277,1397,4,11,-7
2014,1291,1397,16,11,5
2014,1295,1397,12,11,1
2014,1300,1397,14,11,3
2014,1301,1397,12,11,1
2014,1304,1397,11,11,0
2014,1307,1397,7,11,-4
2014,1308,1397,13,11,2
2014,1314,1397,6,11,-5
2014,1326,1397,6,11,-5
2014,1328,1397,5,11,-6
2014,1329,1397,9,11,-2
2014,1332,1397,7,11,-4
2014,1338,1397,9,11,-2
2014,1344,1397,11,11,0
2014,1361,1397,4,11,-7
2014,1372,1397,12,11,1
2014,1386,1397,10,11,-1
2014,1387,1397,5,11,-6
2014,1390,1397,10,11,-1
2014,1393,1397,3,11,-8
2014,1107,1400,16,7,9
2014,1110,1400,15,7,8
2014,1112,1400,1,7,-6
2014,1113,1400,10,7,3
2014,1124,1400,6,7,-1
2014,1140,1400,10,7,3
2014,1142,1400,16,7,9
2014,1153,1400,5,7,-2
2014,1157,1400,16,7,9
2014,1160,1400,8,7,1
2014,1163,1400,7,7,0
2014,1166,1400,3,7,-4
2014,1173,1400,11,7,4
2014,1174,1400,13,7,6
2014,1181,1400,3,7,-4
2014,1184,1400,15,7,8
2014,1196,1400,1,7,-6
2014,1203,1400,9,7,2
2014,1211,1400,8,7,1
2014,1217,1400,12,7,5
2014,1234,1400,11,7,4
2014,1235,1400,3,7,-4
2014,1242,1400,2,7,-5
2014,1243,1400,9,7,2
2014,1246,1400,8,7,1
2014,1257,1400,4,7,-3
2014,1264,1400,13,7,6
2014,1269,1400,6,7,-1
2014,1272,1400,8,7,1
2014,1273,1400,14,7,7
2014,1276,1400,2,7,-5
2014,1277,1400,4,7,-3
2014,1291,1400,16,7,9
2014,1295,1400,12,7,5
2014,1300,1400,14,7,7
2014,1301,1400,12,7,5
2014,1304,1400,11,7,4
2014,1307,1400,7,7,0
2014,1308,1400,13,7,6
2014,1314,1400,6,7,-1
2014,1326,1400,6,7,-1
2014,1328,1400,5,7,-2
2014,1329,1400,9,7,2
2014,1332,1400,7,7,0
2014,1338,1400,9,7,2
2014,1344,1400,11,7,4
2014,1361,1400,4,7,-3
2014,1372,1400,12,7,5
2014,1386,1400,10,7,3
2014,1387,1400,5,7,-2
2014,1390,1400,10,7,3
2014,1393,1400,3,7,-4
2014,1397,1400,11,7,4
2014,1107,1409,16,13,3
2014,1110,1409,15,13,2
2014,1112,1409,1,13,-12
2014,1113,1409,10,13,-3
2014,1124,1409,6,13,-7
2014,1140,1409,10,13,-3
2014,1142,1409,16,13,3
2014,1153,1409,5,13,-8
2014,1157,1409,16,13,3
2014,1160,1409,8,13,-5
2014,1163,1409,7,13,-6
2014,1166,1409,3,13,-10
2014,1173,1409,11,13,-2
2014,1174,1409,13,13,0
2014,1181,1409,3,13,-10
2014,1184,1409,15,13,2
2014,1196,1409,1,13,-12
2014,1203,1409,9,13,-4
2014,1211,1409,8,13,-5
2014,1217,1409,12,13,-1
2014,1234,1409,11,13,-2
2014,1235,1409,3,13,-10
2014,1242,1409,2,13,-11
2014,1243,1409,9,13,-4
2014,1246,1409,8,13,-5
2014,1257,1409,4,13,-9
2014,1264,1409,13,13,0
2014,1269,1409,6,13,-7
2014,1272,1409,8,13,-5
2014,1273,1409,14,13,1
2014,1276,1409,2,13,-11
2014,1277,1409,4,13,-9
2014,1291,1409,16,13,3
2014,1295,1409,12,13,-1
2014,1300,1409,14,13,1
2014,1301,1409,12,13,-1
2014,1304,1409,11,13,-2
2014,1307,1409,7,13,-6
2014,1308,1409,13,13,0
2014,1314,1409,6,13,-7
2014,1326,1409,6,13,-7
2014,1328,1409,5,13,-8
2014,1329,1409,9,13,-4
2014,1332,1409,7,13,-6
2014,1338,1409,9,13,-4
2014,1344,1409,11,13,-2
2014,1361,1409,4,13,-9
2014,1372,1409,12,13,-1
2014,1386,1409,10,13,-3
2014,1387,1409,5,13,-8
2014,1390,1409,10,13,-3
2014,1393,1409,3,13,-10
2014,1397,1409,11,13,-2
2014,1400,1409,7,13,-6
2014,1107,1411,16,16,0
2014,1110,1411,15,16,-1
2014,1112,1411,1,16,-15
2014,1113,1411,10,16,-6
2014,1124,1411,6,16,-10
2014,1140,1411,10,16,-6
2014,1142,1411,16,16,0
2014,1153,1411,5,16,-11
2014,1157,1411,16,16,0
2014,1160,1411,8,16,-8
2014,1163,1411,7,16,-9
2014,1166,1411,3,16,-13
2014,1173,1411,11,16,-5
2014,1174,1411,13,16,-3
2014,1181,1411,3,16,-13
2014,1184,1411,15,16,-1
2014,1196,1411,1,16,-15
2014,1203,1411,9,16,-7
2014,1211,1411,8,16,-8
2014,1217,1411,12,16,-4
2014,1234,1411,11,16,-5
2014,1235,1411,3,16,-13
2014,1242,1411,2,16,-14
2014,1243,1411,9,16,-7
2014,1246,1411,8,16,-8
2014,1257,1411,4,16,-12
2014,1264,1411,13,16,-3
2014,1269,1411,6,16,-10
2014,1272,1411,8,16,-8
2014,1273,1411,14,16,-2
2014,1276,1411,2,16,-14
2014,1277,1411,4,16,-12
2014,1291,1411,16,16,0
2014,1295,1411,12,16,-4
2014,1300,1411,14,16,-2
2014,1301,1411,12,16,-4
2014,1304,1411,11,16,-5
2014,1307,1411,7,16,-9
2014,1308,1411,13,16,-3
2014,1314,1411,6,16,-10
2014,1326,1411,6,16,-10
2014,1328,1411,5,16,-11
2014,1329,1411,9,16,-7
2014,1332,1411,7,16,-9
2014,1338,1411,9,16,-7
2014,1344,1411,11,16,-5
2014,1361,1411,4,16,-12
2014,1372,1411,12,16,-4
2014,1386,1411,10,16,-6
2014,1387,1411,5,16,-11
2014,1390,1411,10,16,-6
2014,1393,1411,3,16,-13
2014,1397,1411,11,16,-5
2014,1400,1411,7,16,-9
2014,1409,1411,13,16,-3
2014,1107,1417,16,4,12
2014,1110,1417,15,4,11
2014,1112,1417,1,4,-3
2014,1113,1417,10,4,6
2014,1124,1417,6,4,2
2014,1140,1417,10,4,6
2014,1142,1417,16,4,12
2014,1153,1417,5,4,1
2014,1157,1417,16,4,12
2014,1160,1417,8,4,4
2014,1163,1417,7,4,3
2014,1166,1417,3,4,-1
2014,1173,1417,11,4,7
2014,1174,1417,13,4,9
2014,1181,1417,3,4,-1
2014,1184,1417,15,4,11
2014,1196,1417,1,4,-3
2014,1203,1417,9,4,5
2014,1211,1417,8,4,4
2014,1217,1417,12,4,8
2014,1234,1417,11,4,7
2014,1235,1417,3,4,-1
2014,1242,1417,2,4,-2
2014,1243,1417,9,4,5
2014,1246,1417,8,4,4
2014,1257,1417,4,4,0
2014,1264,1417,13,4,9
2014,1269,1417,6,4,2
2014,1272,1417,8,4,4
2014,1273,1417,14,4,10
2014,1276,1417,2,4,-2
2014,1277,1417,4,4,0
2014,1291,1417,16,4,12
2014,1295,1417,12,4,8
2014,1300,1417,14,4,10
2014,1301,1417,12,4,8
2014,1304,1417,11,4,7
2014,1307,1417,7,4,3
2014,1308,1417,13,4,9
2014,1314,1417,6,4,2
2014,1326,1417,6,4,2
2014,1328,1417,5,4,1
2014,1329,1417,9,4,5
2014,1332,1417,7,4,3
2014,1338,1417,9,4,5
2014,1344,1417,11,4,7
2014,1361,1417,4,4,0
2014,1372,1417,12,4,8
2014,1386,1417,10,4,6
2014,1387,1417,5,4,1
2014,1390,1417,10,4,6
2014,1393,1417,3,4,-1
2014,1397,1417,11,4,7
2014,1400,1417,7,4,3
2014,1409,1417,13,4,9
2014,1411,1417,16,4,12
2014,1107,1418,16,14,2
2014,1110,1418,15,14,1
2014,1112,1418,1,14,-13
2014,1113,1418,10,14,-4
2014,1124,1418,6,14,-8
2014,1140,1418,10,14,-4
2014,1142,1418,16,14,2
2014,1153,1418,5,14,-9
2014,1157,1418,16,14,2
2014,1160,1418,8,14,-6
2014,1163,1418,7,14,-7
2014,1166,1418,3,14,-11
2014,1173,1418,11,14,-3
2014,1174,1418,13,14,-1
2014,1181,1418,3,14,-11
2014,1184,1418,15,14,1
2014,1196,1418,1,14,-13
2014,1203,1418,9,14,-5
2014,1211,1418,8,14,-6
2014,1217,1418,12,14,-2
2014,1234,1418,11,14,-3
2014,1235,1418,3,14,-11
2014,1242,1418,2,14,-12
2014,1243,1418,9,14,-5
2014,1246,1418,8,14,-6
2014,1257,1418,4,14,-10
2014,1264,1418,13,14,-1
2014,1269,1418,6,14,-8
2014,1272,1418,8,14,-6
2014,1273,1418,14,14,0
2014,1276,1418,2,14,-12
2014,1277,1418,4,14,-10
2014,1291,1418,16,14,2
2014,1295,1418,12,14,-2
2014,1300,1418,14,14,0
2014,1301,1418,12,14,-2
2014,1304,1418,11,14,-3
2014,1307,1418,7,14,-7
2014,1308,1418,13,14,-1
2014,1314,1418,6,14,-8
2014,1326,1418,6,14,-8
2014,1328,1418,5,14,-9
2014,1329,1418,9,14,-5
2014,1332,1418,7,14,-7
2014,1338,1418,9,14,-5
2014,1344,1418,11,14,-3
2014,1361,1418,4,14,-10
2014,1372,1418,12,14,-2
2014,1386,1418,10,14,-4
2014,1387,1418,5,14,-9
2014,1390,1418,10,14,-4
2014,1393,1418,3,14,-11
2014,1397,1418,11,14,-3
2014,1400,1418,7,14,-7
2014,1409,1418,13,14,-1
2014,1411,1418,16,14,2
2014,1417,1418,4,14,-10
2014,1107,1433,16,5,11
2014,1110,1433,15,5,10
2014,1112,1433,1,5,-4
2014,1113,1433,10,5,5
2014,1124,1433,6,5,1
2014,1140,1433,10,5,5
2014,1142,1433,16,5,11
2014,1153,1433,5,5,0
2014,1157,1433,16,5,11
2014,1160,1433,8,5,3
2014,1163,1433,7,5,2
2014,1166,1433,3,5,-2
2014,1173,1433,11,5,6
2014,1174,1433,13,5,8
2014,1181,1433,3,5,-2
2014,1184,1433,15,5,10
2014,1196,1433,1,5,-4
2014,1203,1433,9,5,4
2014,1211,1433,8,5,3
2014,1217,1433,12,5,7
2014,1234,1433,11,5,6
2014,1235,1433,3,5,-2
2014,1242,1433,2,5,-3
2014,1243,1433,9,5,4
2014,1246,1433,8,5,3
2014,1257,1433,4,5,-1
2014,1264,1433,13,5,8
2014,1269,1433,6,5,1
2014,1272,1433,8,5,3
2014,1273,1433,14,5,9
2014,1276,1433,2,5,-3
2014,1277,1433,4,5,-1
2014,1291,1433,16,5,11
2014,1295,1433,12,5,7
2014,1300,1433,14,5,9
2014,1301,1433,12,5,7
2014,1304,1433,11,5,6
2014,1307,1433,7,5,2
2014,1308,1433,13,5,8
2014,1314,1433,6,5,1
2014,1326,1433,6,5,1
2014,1328,1433,5,5,0
2014,1329,1433,9,5,4
2014,1332,1433,7,5,2
2014,1338,1433,9,5,4
2014,1344,1433,11,5,6
2014,1361,1433,4,5,-1
2014,1372,1433,12,5,7
2014,1386,1433,10,5,5
2014,1387,1433,5,5,0
2014,1390,1433,10,5,5
2014,1393,1433,3,5,-2
2014,1397,1433,11,5,6
2014,1400,1433,7,5,2
2014,1409,1433,13,5,8
2014,1411,1433,16,5,11
2014,1417,1433,4,5,-1
2014,1418,1433,14,5,9
2014,1107,1437,16,2,14
2014,1110,1437,15,2,13
2014,1112,1437,1,2,-1
2014,1113,1437,10,2,8
2014,1124,1437,6,2,4
2014,1140,1437,10,2,8
2014,1142,1437,16,2,14
2014,1153,1437,5,2,3
2014,1157,1437,16,2,14
2014,1160,1437,8,2,6
2014,1163,1437,7,2,5
2014,1166,1437,3,2,1
2014,1173,1437,11,2,9
2014,1174,1437,13,2,11
2014,1181,1437,3,2,1
2014,1184,1437,15,2,13
2014,1196,1437,1,2,-1
2014,1203,1437,9,2,7
2014,1211,1437,8,2,6
2014,1217,1437,12,2,10
2014,1234,1437,11,2,9
2014,1235,1437,3,2,1
2014,1242,1437,2,2,0
2014,1243,1437,9,2,7
2014,1246,1437,8,2,6
2014,1257,1437,4,2,2
2014,1264,1437,13,2,11
2014,1269,1437,6,2,4
2014,1272,1437,8,2,6
2014,1273,1437,14,2,12
2014,1276,1437,2,2,0
2014,1277,1437,4,2,2
2014,1291,1437,16,2,14
2014,1295,1437,12,2,10
2014,1300,1437,14,2,12
2014,1301,1437,12,2,10
2014,1304,1437,11,2,9
2014,1307,1437,7,2,5
2014,1308,1437,13,2,11
2014,1314,1437,6,2,4
2014,1326,1437,6,2,4
2014,1328,1437,5,2,3
2014,1329,1437,9,2,7
2014,1332,1437,7,2,5
2014,1338,1437,9,2,7
2014,1344,1437,11,2,9
2014,1361,1437,4,2,2
2014,1372,1437,12,2,10
2014,1386,1437,10,2,8
2014,1387,1437,5,2,3
2014,1390,1437,10,2,8
2014,1393,1437,3,2,1
2014,1397,1437,11,2,9
2014,1400,1437,7,2,5
2014,1409,1437,13,2,11
2014,1411,1437,16,2,14
2014,1417,1437,4,2,2
2014,1418,1437,14,2,12
2014,1433,1437,5,2,3
2014,1107,1438,16,1,15
2014,1110,1438,15,1,14
2014,1112,1438,1,1,0
2014,1113,1438,10,1,9
2014,1124,1438,6,1,5
2014,1140,1438,10,1,9
2014,1142,1438,16,1,15
2014,1153,1438,5,1,4
2014,1157,1438,16,1,15
2014,1160,1438,8,1,7
2014,1163,1438,7,1,6
2014,1166,1438,3,1,2
2014,1173,1438,11,1,10
2014,1174,1438,13,1,12
2014,1181,1438,3,1,2
2014,1184,1438,15,1,14
2014,1196,1438,1,1,0
2014,1203,1438,9,1,8
2014,1211,1438,8,1,7
2014,1217,1438,12,1,11
2014,1234,1438,11,1,10
2014,1235,1438,3,1,2
2014,1242,1438,2,1,1
2014,1243,1438,9,1,8
2014,1246,1438,8,1,7
2014,1257,1438,4,1,3
2014,1264,1438,13,1,12
2014,1269,1438,6,1,5
2014,1272,1438,8,1,7
2014,1273,1438,14,1,13
2014,1276,1438,2,1,1
2014,1277,1438,4,1,3
2014,1291,1438,16,1,15
2014,1295,1438,12,1,11
2014,1300,1438,14,1,13
2014,1301,1438,12,1,11
2014,1304,1438,11,1,10
2014,1307,1438,7,1,6
2014,1308,1438,13,1,12
2014,1314,1438,6,1,5
2014,1326,1438,6,1,5
2014,1328,1438,5,1,4
2014,1329,1438,9,1,8
2014,1332,1438,7,1,6
2014,1338,1438,9,1,8
2014,1344,1438,11,1,10
2014,1361,1438,4,1,3
2014,1372,1438,12,1,11
2014,1386,1438,10,1,9
2014,1387,1438,5,1,4
2014,1390,1438,10,1,9
2014,1393,1438,3,1,2
2014,1397,1438,11,1,10
2014,1400,1438,7,1,6
2014,1409,1438,13,1,12
2014,1411,1438,16,1,15
2014,1417,1438,4,1,3
2014,1418,1438,14,1,13
2014,1433,1438,5,1,4
2014,1437,1438,2,1,1
2014,1107,1444,16,14,2
2014,1110,1444,15,14,1
2014,1112,1444,1,14,-13
2014,1113,1444,10,14,-4
2014,1124,1444,6,14,-8
2014,1140,1444,10,14,-4
2014,1142,1444,16,14,2
2014,1153,1444,5,14,-9
2014,1157,1444,16,14,2
2014,1160,1444,8,14,-6
2014,1163,1444,7,14,-7
2014,1166,1444,3,14,-11
2014,1173,1444,11,14,-3
2014,1174,1444,13,14,-1
2014,1181,1444,3,14,-11
2014,1184,1444,15,14,1
2014,1196,1444,1,14,-13
2014,1203,1444,9,14,-5
2014,1211,1444,8,14,-6
2014,1217,1444,12,14,-2
2014,1234,1444,11,14,-3
2014,1235,1444,3,14,-11
2014,1242,1444,2,14,-12
2014,1243,1444,9,14,-5
2014,1246,1444,8,14,-6
2014,1257,1444,4,14,-10
2014,1264,1444,13,14,-1
2014,1269,1444,6,14,-8
2014,1272,1444,8,14,-6
2014,1273,1444,14,14,0
2014,1276,1444,2,14,-12
2014,1277,1444,4,14,-10
2014,1291,1444,16,14,2
2014,1295,1444,12,14,-2
2014,1300,1444,14,14,0
2014,1301,1444,12,14,-2
2014,1304,1444,11,14,-3
2014,1307,1444,7,14,-7
2014,1308,1444,13,14,-1
2014,1314,1444,6,14,-8
2014,1326,1444,6,14,-8
2014,1328,1444,5,14,-9
2014,1329,1444,9,14,-5
2014,1332,1444,7,14,-7
2014,1338,1444,9,14,-5
2014,1344,1444,11,14,-3
2014,1361,1444,4,14,-10
2014,1372,1444,12,14,-2
2014,1386,1444,10,14,-4
2014,1387,1444,5,14,-9
2014,1390,1444,10,14,-4
2014,1393,1444,3,14,-11
2014,1397,1444,11,14,-3
2014,1400,1444,7,14,-7
2014,1409,1444,13,14,-1
2014,1411,1444,16,14,2
2014,1417,1444,4,14,-10
2014,1418,1444,14,14,0
2014,1433,1444,5,14,-9
2014,1437,1444,2,14,-12
2014,1438,1444,1,14,-13
2014,1107,1451,16,16,0
2014,1110,1451,15,16,-1
2014,1112,1451,1,16,-15
2014,1113,1451,10,16,-6
2014,1124,1451,6,16,-10
2014,1140,1451,10,16,-6
2014,1142,1451,16,16,0
2014,1153,1451,5,16,-11
2014,1157,1451,16,16,0
2014,1160,1451,8,16,-8
2014,1163,1451,7,16,-9
2014,1166,1451,3,16,-13
2014,1173,1451,11,16,-5
2014,1174,1451,13,16,-3
2014,1181,1451,3,16,-13
2014,1184,1451,15,16,-1
2014,1196,1451,1,16,-15
2014,1203,1451,9,16,-7
2014,1211,1451,8,16,-8
2014,1217,1451,12,16,-4
2014,1234,1451,11,16,-5
2014,1235,1451,3,16,-13
2014,1242,1451,2,16,-14
2014,1243,1451,9,16,-7
2014,1246,1451,8,16,-8
2014,1257,1451,4,16,-12
2014,1264,1451,13,16,-3
2014,1269,1451,6,16,-10
2014,1272,1451,8,16,-8
2014,1273,1451,14,16,-2
2014,1276,1451,2,16,-14
2014,1277,1451,4,16,-12
2014,1291,1451,16,16,0
2014,1295,1451,12,16,-4
2014,1300,1451,14,16,-2
2014,1301,1451,12,16,-4
2014,1304,1451,11,16,-5
2014,1307,1451,7,16,-9
2014,1308,1451,13,16,-3
2014,1314,1451,6,16,-10
2014,1326,1451,6,16,-10
2014,1328,1451,5,16,-11
2014,1329,1451,9,16,-7
2014,1332,1451,7,16,-9
2014,1338,1451,9,16,-7
2014,1344,1451,11,16,-5
2014,1361,1451,4,16,-12
2014,1372,1451,12,16,-4
2014,1386,1451,10,16,-6
2014,1387,1451,5,16,-11
2014,1390,1451,10,16,-6
2014,1393,1451,3,16,-13
2014,1397,1451,11,16,-5
2014,1400,1451,7,16,-9
2014,1409,1451,13,16,-3
2014,1411,1451,16,16,0
2014,1417,1451,4,16,-12
2014,1418,1451,14,16,-2
2014,1433,1451,5,16,-11
2014,1437,1451,2,16,-14
2014,1438,1451,1,16,-15
2014,1444,1451,14,16,-2
2014,1107,1454,16,15,1
2014,1110,1454,15,15,0
2014,1112,1454,1,15,-14
2014,1113,1454,10,15,-5
2014,1124,1454,6,15,-9
2014,1140,1454,10,15,-5
2014,1142,1454,16,15,1
2014,1153,1454,5,15,-10
2014,1157,1454,16,15,1
2014,1160,1454,8,15,-7
2014,1163,1454,7,15,-8
2014,1166,1454,3,15,-12
2014,1173,1454,11,15,-4
2014,1174,1454,13,15,-2
2014,1181,1454,3,15,-12
2014,1184,1454,15,15,0
2014,1196,1454,1,15,-14
2014,1203,1454,9,15,-6
2014,1211,1454,8,15,-7
2014,1217,1454,12,15,-3
2014,1234,1454,11,15,-4
2014,1235,1454,3,15,-12
2014,1242,1454,2,15,-13
2014,1243,1454,9,15,-6
2014,1246,1454,8,15,-7
2014,1257,1454,4,15,-11
2014,1264,1454,13,15,-2
2014,1269,1454,6,15,-9
2014,1272,1454,8,15,-7
2014,1273,1454,14,15,-1
2014,1276,1454,2,15,-13
2014,1277,1454,4,15,-11
2014,1291,1454,16,15,1
2014,1295,1454,12,15,-3
2014,1300,1454,14,15,-1
2014,1301,1454,12,15,-3
2014,1304,1454,11,15,-4
2014,1307,1454,7,15,-8
2014,1308,1454,13,15,-2
2014,1314,1454,6,15,-9
2014,1326,1454,6,15,-9
2014,1328,1454,5,15,-10
2014,1329,1454,9,15,-6
2014,1332,1454,7,15,-8
2014,1338,1454,9,15,-6
2014,1344,1454,11,15,-4
2014,1361,1454,4,15,-11
2014,1372,1454,12,15,-3
2014,1386,1454,10,15,-5
2014,1387,1454,5,15,-10
2014,1390,1454,10,15,-5
2014,1393,1454,3,15,-12
2014,1397,1454,11,15,-4
2014,1400,1454,7,15,-8
2014,1409,1454,13,15,-2
2014,1411,1454,16,15,1
2014,1417,1454,4,15,-11
2014,1418,1454,14,15,-1
2014,1433,1454,5,15,-10
2014,1437,1454,2,15,-13
2014,1438,1454,1,15,-14
2014,1444,1454,14,15,-1
2014,1451,1454,16,15,1
2014,1107,1455,16,1,15
2014,1110,1455,15,1,14
2014,1112,1455,1,1,0
2014,1113,1455,10,1,9
2014,1124,1455,6,1,5
2014,1140,1455,10,1,9
2014,1142,1455,16,1,15
2014,1153,1455,5,1,4
2014,1157,1455,16,1,15
2014,1160,1455,8,1,7
2014,1163,1455,7,1,6
2014,1166,1455,3,1,2
2014,1173,1455,11,1,10
2014,1174,1455,13,1,12
2014,1181,1455,3,1,2
2014,1184,1455,15,1,14
2014,1196,1455,1,1,0
2014,1203,1455,9,1,8
2014,1211,1455,8,1,7
2014,1217,1455,12,1,11
2014,1234,1455,11,1,10
2014,1235,1455,3,1,2
2014,1242,1455,2,1,1
2014,1243,1455,9,1,8
2014,1246,1455,8,1,7
2014,1257,1455,4,1,3
2014,1264,1455,13,1,12
2014,1269,1455,6,1,5
2014,1272,1455,8,1,7
2014,1273,1455,14,1,13
2014,1276,1455,2,1,1
2014,1277,1455,4,1,3
2014,1291,1455,16,1,15
2014,1295,1455,12,1,11
2014,1300,1455,14,1,13
2014,1301,1455,12,1,11
2014,1304,1455,11,1,10
2014,1307,1455,7,1,6
2014,1308,1455,13,1,12
2014,1314,1455,6,1,5
2014,1326,1455,6,1,5
2014,1328,1455,5,1,4
2014,1329,1455,9,1,8
2014,1332,1455,7,1,6
2014,1338,1455,9,1,8
2014,1344,1455,11,1,10
2014,1361,1455,4,1,3
2014,1372,1455,12,1,11
2014,1386,1455,10,1,9
2014,1387,1455,5,1,4
2014,1390,1455,10,1,9
2014,1393,1455,3,1,2
2014,1397,1455,11,1,10
2014,1400,1455,7,1,6
2014,1409,1455,13,1,12
2014,1411,1455,16,1,15
2014,1417,1455,4,1,3
2014,1418,1455,14,1,13
2014,1433,1455,5,1,4
2014,1437,1455,2,1,1
2014,1438,1455,1,1,0
2014,1444,1455,14,1,13
2014,1451,1455,16,1,15
2014,1454,1455,15,1,14
2014,1107,1458,16,2,14
2014,1110,1458,15,2,13
2014,1112,1458,1,2,-1
2014,1113,1458,10,2,8
2014,1124,1458,6,2,4
2014,1140,1458,10,2,8
2014,1142,1458,16,2,14
2014,1153,1458,5,2,3
2014,1157,1458,16,2,14
2014,1160,1458,8,2,6
2014,1163,1458,7,2,5
2014,1166,1458,3,2,1
2014,1173,1458,11,2,9
2014,1174,1458,13,2,11
2014,1181,1458,3,2,1
2014,1184,1458,15,2,13
2014,1196,1458,1,2,-1
2014,1203,1458,9,2,7
2014,1211,1458,8,2,6
2014,1217,1458,12,2,10
2014,1234,1458,11,2,9
2014,1235,1458,3,2,1
2014,1242,1458,2,2,0
2014,1243,1458,9,2,7
2014,1246,1458,8,2,6
2014,1257,1458,4,2,2
2014,1264,1458,13,2,11
2014,1269,1458,6,2,4
2014,1272,1458,8,2,6
2014,1273,1458,14,2,12
2014,1276,1458,2,2,0
2014,1277,1458,4,2,2
2014,1291,1458,16,2,14
2014,1295,1458,12,2,10
2014,1300,1458,14,2,12
2014,1301,1458,12,2,10
2014,1304,1458,11,2,9
2014,1307,1458,7,2,5
2014,1308,1458,13,2,11
2014,1314,1458,6,2,4
2014,1326,1458,6,2,4
2014,1328,1458,5,2,3
2014,1329,1458,9,2,7
2014,1332,1458,7,2,5
2014,1338,1458,9,2,7
2014,1344,1458,11,2,9
2014,1361,1458,4,2,2
2014,1372,1458,12,2,10
2014,1386,1458,10,2,8
2014,1387,1458,5,2,3
2014,1390,1458,10,2,8
2014,1393,1458,3,2,1
2014,1397,1458,11,2,9
2014,1400,1458,7,2,5
2014,1409,1458,13,2,11
2014,1411,1458,16,2,14
2014,1417,1458,4,2,2
2014,1418,1458,14,2,12
2014,1433,1458,5,2,3
2014,1437,1458,2,2,0
2014,1438,1458,1,2,-1
2014,1444,1458,14,2,12
2014,1451,1458,16,2,14
2014,1454,1458,15,2,13
2014,1455,1458,1,2,-1
2014,1107,1459,16,15,1
2014,1110,1459,15,15,0
2014,1112,1459,1,15,-14
2014,1113,1459,10,15,-5
2014,1124,1459,6,15,-9
2014,1140,1459,10,15,-5
2014,1142,1459,16,15,1
2014,1153,1459,5,15,-10
2014,1157,1459,16,15,1
2014,1160,1459,8,15,-7
2014,1163,1459,7,15,-8
2014,1166,1459,3,15,-12
2014,1173,1459,11,15,-4
2014,1174,1459,13,15,-2
2014,1181,1459,3,15,-12
2014,1184,1459,15,15,0
2014,1196,1459,1,15,-14
2014,1203,1459,9,15,-6
2014,1211,1459,8,15,-7
2014,1217,1459,12,15,-3
2014,1234,1459,11,15,-4
2014,1235,1459,3,15,-12
2014,1242,1459,2,15,-13
2014,1243,1459,9,15,-6
2014,1246,1459,8,15,-7
2014,1257,1459,4,15,-11
2014,1264,1459,13,15,-2
2014,1269,1459,6,15,-9
2014,1272,1459,8,15,-7
2014,1273,1459,14,15,-1
2014,1276,1459,2,15,-13
2014,1277,1459,4,15,-11
2014,1291,1459,16,15,1
2014,1295,1459,12,15,-3
2014,1300,1459,14,15,-1
2014,1301,1459,12,15,-3
2014,1304,1459,11,15,-4
2014,1307,1459,7,15,-8
2014,1308,1459,13,15,-2
2014,1314,1459,6,15,-9
2014,1326,1459,6,15,-9
2014,1328,1459,5,15,-10
2014,1329,1459,9,15,-6
2014,1332,1459,7,15,-8
2014,1338,1459,9,15,-6
2014,1344,1459,11,15,-4
2014,1361,1459,4,15,-11
2014,1372,1459,12,15,-3
2014,1386,1459,10,15,-5
2014,1387,1459,5,15,-10
2014,1390,1459,10,15,-5
2014,1393,1459,3,15,-12
2014,1397,1459,11,15,-4
2014,1400,1459,7,15,-8
2014,1409,1459,13,15,-2
2014,1411,1459,16,15,1
2014,1417,1459,4,15,-11
2014,1418,1459,14,15,-1
2014,1433,1459,5,15,-10
2014,1437,1459,2,15,-13
2014,1438,1459,1,15,-14
2014,1444,1459,14,15,-1
2014,1451,1459,16,15,1
2014,1454,1459,15,15,0
2014,1455,1459,1,15,-14
2014,1458,1459,2,15,-13
2014,1107,1462,16,12,4
2014,1110,1462,15,12,3
2014,1112,1462,1,12,-11
2014,1113,1462,10,12,-2
2014,1124,1462,6,12,-6
2014,1140,1462,10,12,-2
2014,1142,1462,16,12,4
2014,1153,1462,5,12,-7
2014,1157,1462,16,12,4
2014,1160,1462,8,12,-4
2014,1163,1462,7,12,-5
2014,1166,1462,3,12,-9
2014,1173,1462,11,12,-1
2014,1174,1462,13,12,1
2014,1181,1462,3,12,-9
2014,1184,1462,15,12,3
2014,1196,1462,1,12,-11
2014,1203,1462,9,12,-3
2014,1211,1462,8,12,-4
2014,1217,1462,12,12,0
2014,1234,1462,11,12,-1
2014,1235,1462,3,12,-9
2014,1242,1462,2,12,-10
2014,1243,1462,9,12,-3
2014,1246,1462,8,12,-4
2014,1257,1462,4,12,-8
2014,1264,1462,13,12,1
2014,1269,1462,6,12,-6
2014,1272,1462,8,12,-4
2014,1273,1462,14,12,2
2014,1276,1462,2,12,-10
2014,1277,1462,4,12,-8
2014,1291,1462,16,12,4
2014,1295,1462,12,12,0
2014,1300,1462,14,12,2
2014,1301,1462,12,12,0
2014,1304,1462,11,12,-1
2014,1307,1462,7,12,-5
2014,1308,1462,13,12,1
2014,1314,1462,6,12,-6
2014,1326,1462,6,12,-6
2014,1328,1462,5,12,-7
2014,1329,1462,9,12,-3
2014,1332,1462,7,12,-5
2014,1338,1462,9,12,-3
2014,1344,1462,11,12,-1
2014,1361,1462,4,12,-8
2014,1372,1462,12,12,0
2014,1386,1462,10,12,-2
2014,1387,1462,5,12,-7
2014,1390,1462,10,12,-2
2014,1393,1462,3,12,-9
2014,1397,1462,11,12,-1
2014,1400,1462,7,12,-5
2014,1409,1462,13,12,1
2014,1411,1462,16,12,4
2014,1417,1462,4,12,-8
2014,1418,1462,14,12,2
2014,1433,1462,5,12,-7
2014,1437,1462,2,12,-10
2014,1438,1462,1,12,-11
2014,1444,1462,14,12,2
2014,1451,1462,16,12,4
2014,1454,1462,15,12,3
2014,1455,1462,1,12,-11
2014,1458,1462,2,12,-10
2014,1459,1462,15,12,3
2015,1107,1112,14,2,12
2015,1107,1116,14,5,9
2015,1112,1116,2,5,-3
2015,1107,1124,14,3,11
2015,1112,1124,2,3,-1
2015,1116,1124,5,3,2
2015,1107,1125,14,15,-1
2015,1112,1125,2,15,-13
2015,1116,1125,5,15,-10
2015,1124,1125,3,15,-12
2015,1107,1129,14,11,3
2015,1112,1129,2,11,-9
2015,1116,1129,5,11,-6
2015,1124,1129,3,11,-8
2015,1125,1129,15,11,4
2015,1107,1138,14,12,2
2015,1112,1138,2,12,-10
2015,1116,1138,5,12,-7
2015,1124,1138,3,12,-9
2015,1125,1138,15,12,3
2015,1129,1138,11,12,-1
2015,1107,1139,14,6,8
2015,1112,1139,2,6,-4
2015,1116,1139,5,6,-1
2015,1124,1139,3,6,-3
2015,1125,1139,15,6,9
2015,1129,1139,11,6,5
2015,1138,1139,12,6,6
2015,1107,1140,14,11,3
2015,1112,1140,2,11,-9
2015,1116,1140,5,11,-6
2015,1124,1140,3,11,-8
2015,1125,1140,15,11,4
2015,1129,1140,11,11,0
2015,1138,1140,12,11,1
2015,1139,1140,6,11,-5
2015,1107,1153,14,8,6
2015,1112,1153,2,8,-6
2015,1116,1153,5,8,-3
2015,1124,1153,3,8,-5
2015,1125,1153,15,8,7
2015,1129,1153,11,8,3
2015,1138,1153,12,8,4
2015,1139,1153,6,8,-2
2015,1140,1153,11,8,3
2015,1107,1157,14,16,-2
2015,1112,1157,2,16,-14
2015,1116,1157,5,16,-11
2015,1124,1157,3,16,-13
2015,1125,1157,15,16,-1
2015,1129,1157,11,16,-5
2015,1138,1157,12,16,-4
2015,1139,1157,6,16,-10
2015,1140,1157,11,16,-5
2015,1153,1157,8,16,-8
2015,1107,1172,14,10,4
2015,1112,1172,2,10,-8
2015,1116,1172,5,10,-5
2015,1124,1172,3,10,-7
2015,1125,1172,15,10,5
2015,1129,1172,11,10,1
2015,1138,1172,12,10,2
2015,1139,1172,6,10,-4
2015,1140,1172,11,10,1
2015,1153,1172,8,10,-2
2015,1157,1172,16,10,6
2015,1107,1173,14,11,3
2015,1112,1173,2,11,-9
2015,1116,1173,5,11,-6
2015,1124,1173,3,11,-8
2015,1125,1173,15,11,4
2015,1129,1173,11,11,0
2015,1138,1173,12,11,1
2015,1139,1173,6,11,-5
2015,1140,1173,11,11,0
2015,1153,1173,8,11,-3
2015,1157,1173,16,11,5
2015,1172,1173,10,11,-1
2015,1107,1181,14,1,13
2015,1112,1181,2,1,1
2015,1116,1181,5,1,4
2015,1124,1181,3,1,2
2015,1125,1181,15,1,14
2015,1129,1181,11,1,10
2015,1138,1181,12,1,11
2015,1139,1181,6,1,5
2015,1140,1181,11,1,10
2015,1153,1181,8,1,7
2015,1157,1181,16,1,15
2015,1172,1181,10,1,9
2015,1173,1181,11,1,10
2015,1107,1186,14,13,1
2015,1112,1186,2,13,-11
2015,1116,1186,5,13,-8
2015,1124,1186,3,13,-10
2015,1125,1186,15,13,2
2015,1129,1186,11,13,-2
2015,1138,1186,12,13,-1
2015,1139,1186,6,13,-7
2015,1140,1186,11,13,-2
2015,1153,1186,8,13,-5
2015,1157,1186,16,13,3
2015,1172,1186,10,13,-3
2015,1173,1186,11,13,-2
2015,1181,1186,1,13,-12
2015,1107,1207,14,4,10
2015,1112,1207,2,4,-2
2015,1116,1207,5,4,1
2015,1124,1207,3,4,-1
2015,1125,1207,15,4,11
2015,1129,1207,11,4,7
2015,1138,1207,12,4,8
2015,1139,1207,6,4,2
2015,1140,1207,11,4,7
2015,1153,1207,8,4,4
2015,1157,1207,16,4,12
2015,1172,1207,10,4,6
2015,1173,1207,11,4,7
2015,1181,1207,1,4,-3
2015,1186,1207,13,4,9
2015,1107,1208,14,10,4
2015,1112,1208,2,10,-8
2015,1116,1208,5,10,-5
2015,1124,1208,3,10,-7
2015,1125,1208,15,10,5
2015,1129,1208,11,10,1
2015,1138,1208,12,10,2
2015,1139,1208,6,10,-4
2015,1140,1208,11,10,1
2015,1153,1208,8,10,-2
2015,1157,1208,16,10,6
2015,1172,1208,10,10,0
2015,1173,1208,11,10,1
2015,1181,1208,1,10,-9
2015,1186,1208,13,10,3
2015,1207,1208,4,10,-6
2015,1107,1209,14,14,0
2015,1112,1209,2,14,-12
2015,1116,1209,5,14,-9
2015,1124,1209,3,14,-11
2015,1125,1209,15,14,1
2015,1129,1209,11,14,-3
2015,1138,1209,12,14,-2
2015,1139,1209,6,14,-8
2015,1140,1209,11,14,-3
2015,1153,1209,8,14,-6
2015,1157,1209,16,14,2
2015,1172,1209,10,14,-4
2015,1173,1209,11,14,-3
2015,1181,1209,1,14,-13
2015,1186,1209,13,14,-1
2015,1207,1209,4,14,-10
2015,1208,1209,10,14,-4
2015,1107,1211,14,2,12
2015,1112,1211,2,2,0
2015,1116,1211,5,2,3
2015,1124,1211,3,2,1
2015,1125,1211,15,2,13
2015,1129,1211,11,2,9
2015,1138,1211,12,2,10
2015,1139,1211,6,2,4
2015,1140,1211,11,2,9
2015,1153,1211,8,2,6
2015,1157,1211,16,2,14
2015,1172,1211,10,2,8
2015,1173,1211,11,2,9
2015,1181,1211,1,2,-1
2015,1186,1211,13,2,11
2015,1207,1211,4,2,2
2015,1208,1211,10,2,8
2015,1209,1211,14,2,12
2015,1107,1214,14,16,-2
2015,1112,1214,2,16,-14
2015,1116,1214,5,16,-11
2015,1124,1214,3,16,-13
2015,1125,1214,15,16,-1
2015,1129,1214,11,16,-5
2015,1138,1214,12,16,-4
2015,1139,1214,6,16,-10
2015,1140,1214,11,16,-5
2015,1153,1214,8,16,-8
2015,1157,1214,16,16,0
2015,1172,1214,10,16,-6
2015,1173,1214,11,16,-5
2015,1181,1214,1,16,-15
2015,1186,1214,13,16,-3
2015,1207,1214,4,16,-12
2015,1208,1214,10,16,-6
2015,1209,1214,14,16,-2
2015,1211,1214,2,16,-14
2015,1107,1217,14,13,1
2015,1112,1217,2,13,-11
2015,1116,1217,5,13,-8
2015,1124,1217,3,13,-10
2015,1125,1217,15,13,2
2015,1129,1217,11,13,-2
2015,1138,1217,12,13,-1
2015,1139,1217,6,13,-7
2015,1140,1217,11,13,-2
2015,1153,1217,8,13,-5
2015,1157,1217,16,13,3
2015,1172,1217,10,13,-3
2015,1173,1217,11,13,-2
2015,1181,1217,1,13,-12
2015,1186,1217,13,13,0
2015,1207,1217,4,13,-9
2015,1208,1217,10,13,-3
2015,1209,1217,14,13,1
2015,1211,1217,2,13,-11
2015,1214,1217,16,13,3
2015,1107,1231,14,10,4
2015,1112,1231,2,10,-8
2015,1116,1231,5,10,-5
2015,1124,1231,3,10,-7
2015,1125,1231,15,10,5
2015,1129,1231,11,10,1
2015,1138,1231,12,10,2
2015,1139,1231,6,10,-4
2015,1140,1231,11,10,1
2015,1153,1231,8,10,-2
2015,1157,1231,16,10,6
2015,1172,1231,10,10,0
2015,1173,1231,11,10,1
2015,1181,1231,1,10,-9
2015,1186,1231,13,10,3
2015,1207,1231,4,10,-6
2015,1208,1231,10,10,0
2015,1209,1231,14,10,4
2015,1211,1231,2,10,-8
2015,1214,1231,16,10,6
2015,1217,1231,13,10,3
2015,1107,1234,14,7,7
2015,1112,1234,2,7,-5
2015,1116,1234,5,7,-2
2015,1124,1234,3,7,-4
2015,1125,1234,15,7,8
2015,1129,1234,11,7,4
2015,1138,1234,12,7,5
2015,1139,1234,6,7,-1
2015,1140,1234,11,7,4
2015,1153,1234,8,7,1
2015,1157,1234,16,7,9
2015,1172,1234,10,7,3
2015,1173,1234,11,7,4
2015,1181,1234,1,7,-6
2015,1186,1234,13,7,6
2015,1207,1234,4,7,-3
2015,1208,1234,10,7,3
2015,1209,1234,14,7,7
2015,1211,1234,2,7,-5
2015,1214,1234,16,7,9
2015,1217,1234,13,7,6
2015,1231,1234,10,7,3
2015,1107,1235,14,3,11
2015,1112,1235,2,3,-1
2015,1116,1235,5,3,2
2015,1124,1235,3,3,0
2015,1125,1235,15,3,12
2015,1129,1235,11,3,8
2015,1138,1235,12,3,9
2015,1139,1235,6,3,3
2015,1140,1235,11,3,8
2015,1153,1235,8,3,5
2015,1157,1235,16,3,13
2015,1172,1235,10,3,7
2015,1173,1235,11,3,8
2015,1181,1235,1,3,-2
2015,1186,1235,13,3,10
2015,1207,1235,4,3,1
2015,1208,1235,10,3,7
2015,1209,1235,14,3,11
2015,1211,1235,2,3,-1
2015,1214,1235,16,3,13
2015,1217,1235,13,3,10
2015,1231,1235,10,3,7
2015,1234,1235,7,3,4
2015,1107,1242,14,2,12
2015,1112,1242,2,2,0
2015,1116,1242,5,2,3
2015,1124,1242,3,2,1
2015,1125,1242,15,2,13
2015,1129,1242,11,2,9
2015,1138,1242,12,2,10
2015,1139,1242,6,2,4
2015,1140,1242,11,2,9
2015,1153,1242,8,2,6
2015,1157,1242,16,2,14
2015,1172,1242,10,2,8
2015,1173,1242,11,2,9
2015,1181,1242,1,2,-1
2015,1186,1242,13,2,11
2015,1207,1242,4,2,2
2015,1208,1242,10,2,8
2015,1209,1242,14,2,12
2015,1211,1242,2,2,0
2015,1214,1242,16,2,14
2015,1217,1242,13,2,11
2015,1231,1242,10,2,8
2015,1234,1242,7,2,5
2015,1235,1242,3,2,1
2015,1107,1246,14,1,13
2015,1112,1246,2,1,1
2015,1116,1246,5,1,4
2015,1124,1246,3,1,2
2015,1125,1246,15,1,14
2015,1129,1246,11,1,10
2015,1138,1246,12,1,11
2015,1139,1246,6,1,5
2015,1140,1246,11,1,10
2015,1153,1246,8,1,7
2015,1157,1246,16,1,15
2015,1172,1246,10,1,9
2015,1173,1246,11,1,10
2015,1181,1246,1,1,0
2015,1186,1246,13,1,12
2015,1207,1246,4,1,3
2015,1208,1246,10,1,9
2015,1209,1246,14,1,13
2015,1211,1246,2,1,1
2015,1214,1246,16,1,15
2015,1217,1246,13,1,12
2015,1231,1246,10,1,9
2015,1234,1246,7,1,6
2015,1235,1246,3,1,2
2015,1242,1246,2,1,1
2015,1107,1248,14,16,-2
2015,1112,1248,2,16,-14
2015,1116,1248,5,16,-11
2015,1124,1248,3,16,-13
2015,1125,1248,15,16,-1
2015,1129,1248,11,16,-5
2015,1138,1248,12,16,-4
2015,1139,1248,6,16,-10
2015,1140,1248,11,16,-5
2015,1153,1248,8,16,-8
2015,1157,1248,16,16,0
2015,1172,1248,10,16,-6
2015,1173,1248,11,16,-5
2015,1181,1248,1,16,-15
2015,1186,1248,13,16,-3
2015,1207,1248,4,16,-12
2015,1208,1248,10,16,-6
2015,1209,1248,14,16,-2
2015,1211,1248,2,16,-14
2015,1214,1248,16,16,0
2015,1217,1248,13,16,-3
2015,1231,1248,10,16,-6
2015,1234,1248,7,16,-9
2015,1235,1248,3,16,-13
2015,1242,1248,2,16,-14
2015,1246,1248,1,16,-15
2015,1107,1257,14,4,10
2015,1112,1257,2,4,-2
2015,1116,1257,5,4,1
2015,1124,1257,3,4,-1
2015,1125,1257,15,4,11
2015,1129,1257,11,4,7
2015,1138,1257,12,4,8
2015,1139,1257,6,4,2
2015,1140,1257,11,4,7
2015,1153,1257,8,4,4
2015,1157,1257,16,4,12
2015,1172,1257,10,4,6
2015,1173,1257,11,4,7
2015,1181,1257,1,4,-3
2015,1186,1257,13,4,9
2015,1207,1257,4,4,0
2015,1208,1257,10,4,6
2015,1209,1257,14,4,10
2015,1211,1257,2,4,-2
2015,1214,1257,16,4,12
2015,1217,1257,13,4,9
2015,1231,1257,10,4,6
2015,1234,1257,7,4,3
2015,1235,1257,3,4,-1
2015,1242,1257,2,4,-2
2015,1246,1257,1,4,-3
2015,1248,1257,16,4,12
2015,1107,1261,14,9,5
2015,1112,1261,2,9,-7
2015,1116,1261,5,9,-4
2015,1124,1261,3,9,-6
2015,1125,1261,15,9,6
2015,1129,1261,11,9,2
2015,1138,1261,12,9,3
2015,1139,1261,6,9,-3
2015,1140,1261,11,9,2
2015,1153,1261,8,9,-1
2015,1157,1261,16,9,7
2015,1172,1261,10,9,1
2015,1173,1261,11,9,2
2015,1181,1261,1,9,-8
2015,1186,1261,13,9,4
2015,1207,1261,4,9,-5
2015,1208,1261,10,9,1
2015,1209,1261,14,9,5
2015,1211,1261,2,9,-7
2015,1214,1261,16,9,7
2015,1217,1261,13,9,4
2015,1231,1261,10,9,1
2015,1234,1261,7,9,-2
2015,1235,1261,3,9,-6
2015,1242,1261,2,9,-7
2015,1246,1261,1,9,-8
2015,1248,1261,16,9,7
2015,1257,1261,4,9,-5
2015,1107,1264,14,16,-2
2015,1112,1264,2,16,-14
2015,1116,1264,5,16,-11
2015,1124,1264,3,16,-13
2015,1125,1264,15,16,-1
2015,1129,1264,11,16,-5
2015,1138,1264,12,16,-4
2015,1139,1264,6,16,-10
2015,1140,1264,11,16,-5
2015,1153,1264,8,16,-8
2015,1157,1264,16,16,0
2015,1172,1264,10,16,-6
2015,1173,1264,11,16,-5
2015,1181,1264,1,16,-15
2015,1186,1264,13,16,-3
2015,1207,1264,4,16,-12
2015,1208,1264,10,16,-6
2015,1209,1264,14,16,-2
2015,1211,1264,2,16,-14
2015,1214,1264,16,16,0
2015,1217,1264,13,16,-3
2015,1231,1264,10,16,-6
2015,1234,1264,7,16,-9
2015,1235,1264,3,16,-13
2015,1242,1264,2,16,-14
2015,1246,1264,1,16,-15
2015,1248,1264,16,16,0
2015,1257,1264,4,16,-12
2015,1261,1264,9,16,-7
2015,1107,1268,14,4,10
2015,1112,1268,2,4,-2
2015,1116,1268,5,4,1
2015,1124,1268,3,4,-1
2015,1125,1268,15,4,11
2015,1129,1268,11,4,7
2015,1138,1268,12,4,8
2015,1139,1268,6,4,2
2015,1140,1268,11,4,7
2015,1153,1268,8,4,4
2015,1157,1268,16,4,12
2015,1172,1268,10,4,6
2015,1173,1268,11,4,7
2015,1181,1268,1,4,-3
2015,1186,1268,13,4,9
2015,1207,1268,4,4,0
2015,1208,1268,10,4,6
2015,1209,1268,14,4,10
2015,1211,1268,2,4,-2
2015,1214,1268,16,4,12
2015,1217,1268,13,4,9
2015,1231,1268,10,4,6
2015,1234,1268,7,4,3
2015,1235,1268,3,4,-1
2015,1242,1268,2,4,-2
2015,1246,1268,1,4,-3
2015,1248,1268,16,4,12
2015,1257,1268,4,4,0
2015,1261,1268,9,4,5
2015,1264,1268,16,4,12
2015,1107,1277,14,7,7
2015,1112,1277,2,7,-5
2015,1116,1277,5,7,-2
2015,1124,1277,3,7,-4
2015,1125,1277,15,7,8
2015,1129,1277,11,7,4
2015,1138,1277,12,7,5
2015,1139,1277,6,7,-1
2015,1140,1277,11,7,4
2015,1153,1277,8,7,1
2015,1157,1277,16,7,9
2015,1172,1277,10,7,3
2015,1173,1277,11,7,4
2015,1181,1277,1,7,-6
2015,1186,1277,13,7,6
2015,1207,1277,4,7,-3
2015,1208,1277,10,7,3
2015,1209,1277,14,7,7
2015,1211,1277,2,7,-5
2015,1214,1277,16,7,9
2015,1217,1277,13,7,6
2015,1231,1277,10,7,3
2015,1234,1277,7,7,0
2015,1235,1277,3,7,-4
2015,1242,1277,2,7,-5
2015,1246,1277,1,7,-6
2015,1248,1277,16,7,9
2015,1257,1277,4,7,-3
2015,1261,1277,9,7,2
2015,1264,1277,16,7,9
2015,1268,1277,4,7,-3
2015,1107,1279,14,11,3
2015,1112,1279,2,11,-9
2015,1116,1279,5,11,-6
2015,1124,1279,3,11,-8
2015,1125,1279,15,11,4
2015,1129,1279,11,11,0
2015,1138,1279,12,11,1
2015,1139,1279,6,11,-5
2015,1140,1279,11,11,0
2015,1153,1279,8,11,-3
2015,1157,1279,16,11,5
2015,1172,1279,10,11,-1
2015,1173,1279,11,11,0
2015,1181,1279,1,11,-10
2015,1186,1279,13,11,2
2015,1207,1279,4,11,-7
2015,1208,1279,10,11,-1
2015,1209,1279,14,11,3
2015,1211,1279,2,11,-9
2015,1214,1279,16,11,5
2015,1217,1279,13,11,2
2015,1231,1279,10,11,-1
2015,1234,1279,7,11,-4
2015,1235,1279,3,11,-8
2015,1242,1279,2,11,-9
2015,1246,1279,1,11,-10
2015,1248,1279,16,11,5
2015,1257,1279,4,11,-7
2015,1261,1279,9,11,-2
2015,1264,1279,16,11,5
2015,1268,1279,4,11,-7
2015,1277,1279,7,11,-4
2015,1107,1295,14,15,-1
2015,1112,1295,2,15,-13
2015,1116,1295,5,15,-10
2015,1124,1295,3,15,-12
2015,1125,1295,15,15,0
2015,1129,1295,11,15,-4
2015,1138,1295,12,15,-3
2015,1139,1295,6,15,-9
2015,1140,1295,11,15,-4
2015,1153,1295,8,15,-7
2015,1157,1295,16,15,1
2015,1172,1295,10,15,-5
2015,1173,1295,11,15,-4
2015,1181,1295,1,15,-14
2015,1186,1295,13,15,-2
2015,1207,1295,4,15,-11
2015,1208,1295,10,15,-5
2015,1209,1295,14,15,-1
2015,1211,1295,2,15,-13
2015,1214,1295,16,15,1
2015,1217,1295,13,15,-2
2015,1231,1295,10,15,-5
2015,1234,1295,7,15,-8
2015,1235,1295,3,15,-12
2015,1242,1295,2,15,-13
2015,1246,1295,1,15,-14
2015,1248,1295,16,15,1
2015,1257,1295,4,15,-11
2015,1261,1295,9,15,-6
2015,1264,1295,16,15,1
2015,1268,1295,4,15,-11
2015,1277,1295,7,15,-8
2015,1279,1295,11,15,-4
2015,1107,1301,14,8,6
2015,1112,1301,2,8,-6
2015,1116,1301,5,8,-3
2015,1124,1301,3,8,-5
2015,1125,1301,15,8,7
2015,1129,1301,11,8,3
2015,1138,1301,12,8,4
2015,1139,1301,6,8,-2
2015,1140,1301,11,8,3
2015,1153,1301,8,8,0
2015,1157,1301,16,8,8
2015,1172,1301,10,8,2
2015,1173,1301,11,8,3
2015,1181,1301,1,8,-7
2015,1186,1301,13,8,5
2015,1207,1301,4,8,-4
2015,1208,1301,10,8,2
2015,1209,1301,14,8,6
2015,1211,1301,2,8,-6
2015,1214,1301,16,8,8
2015,1217,1301,13,8,5
2015,1231,1301,10,8,2
2015,1234,1301,7,8,-1
2015,1235,1301,3,8,-5
2015,1242,1301,2,8,-6
2015,1246,1301,1,8,-7
2015,1248,1301,16,8,8
2015,1257,1301,4,8,-4
2015,1261,1301,9,8,1
2015,1264,1301,16,8,8
2015,1268,1301,4,8,-4
2015,1277,1301,7,8,-1
2015,1279,1301,11,8,3
2015,1295,1301,15,8,7
2015,1107,1308,14,15,-1
2015,1112,1308,2,15,-13
2015,1116,1308,5,15,-10
2015,1124,1308,3,15,-12
2015,1125,1308,15,15,0
2015,1129,1308,11,15,-4
2015,1138,1308,12,15,-3
2015,1139,1308,6,15,-9
2015,1140,1308,11,15,-4
2015,1153,1308,8,15,-7
2015,1157,1308,16,15,1
2015,1172,1308,10,15,-5
2015,1173,1308,11,15,-4
2015,1181,1308,1,15,-14
2015,1186,1308,13,15,-2
2015,1207,1308,4,15,-11
2015,1208,1308,10,15,-5
2015,1209,1308,14,15,-1
2015,1211,1308,2,15,-13
2015,1214,1308,16,15,1
2015,1217,1308,13,15,-2
2015,1231,1308,10,15,-5
2015,1234,1308,7,15,-8
2015,1235,1308,3,15,-12
2015,1242,1308,2,15,-13
2015,1246,1308,1,15,-14
2015,1248,1308,16,15,1
2015,1257,1308,4,15,-11
2015,1261,1308,9,15,-6
2015,1264,1308,16,15,1
2015,1268,1308,4,15,-11
2015,1277,1308,7,15,-8
2015,1279,1308,11,15,-4
2015,1295,1308,15,15,0
2015,1301,1308,8,15,-7
2015,1107,1314,14,4,10
2015,1112,1314,2,4,-2
2015,1116,1314,5,4,1
2015,1124,1314,3,4,-1
2015,1125,1314,15,4,11
2015,1129,1314,11,4,7
2015,1138,1314,12,4,8
2015,1139,1314,6,4,2
2015,1140,1314,11,4,7
2015,1153,1314,8,4,4
2015,1157,1314,16,4,12
2015,1172,1314,10,4,6
2015,1173,1314,11,4,7
2015,1181,1314,1,4,-3
2015,1186,1314,13,4,9
2015,1207,1314,4,4,0
2015,1208,1314,10,4,6
2015,1209,1314,14,4,10
2015,1211,1314,2,4,-2
2015,1214,1314,16,4,12
2015,1217,1314,13,4,9
2015,1231,1314,10,4,6
2015,1234,1314,7,4,3
2015,1235,1314,3,4,-1
2015,1242,1314,2,4,-2
2015,1246,1314,1,4,-3
2015,1248,1314,16,4,12
2015,1257,1314,4,4,0
2015,1261,1314,9,4,5
2015,1264,1314,16,4,12
2015,1268,1314,4,4,0
2015,1277,1314,7,4,3
2015,1279,1314,11,4,7
2015,1295,1314,15,4,11
2015,1301,1314,8,4,4
2015,1308,1314,15,4,11
2015,1107,1316,14,16,-2
2015,1112,1316,2,16,-14
2015,1116,1316,5,16,-11
2015,1124,1316,3,16,-13
2015,1125,1316,15,16,-1
2015,1129,1316,11,16,-5
2015,1138,1316,12,16,-4
2015,1139,1316,6,16,-10
2015,1140,1316,11,16,-5
2015,1153,1316,8,16,-8
2015,1157,1316,16,16,0
2015,1172,1316,10,16,-6
2015,1173,1316,11,16,-5
2015,1181,1316,1,16,-15
2015,1186,1316,13,16,-3
2015,1207,1316,4,16,-12
2015,1208,1316,10,16,-6
2015,1209,1316,14,16,-2
2015,1211,1316,2,16,-14
2015,1214,1316,16,16,0
2015,1217,1316,13,16,-3
2015,1231,1316,10,16,-6
2015,1234,1316,7,16,-9
2015,1235,1316,3,16,-13
2015,1242,1316,2,16,-14
2015,1246,1316,1,16,-15
2015,1248,1316,16,16,0
2015,1257,1316,4,16,-12
2015,1261,1316,9,16,-7
2015,1264,1316,16,16,0
2015,1268,1316,4,16,-12
2015,1277,1316,7,16,-9
2015,1279,1316,11,16,-5
2015,1295,1316,15,16,-1
2015,1301,1316,8,16,-8
2015,1308,1316,15,16,-1
2015,1314,1316,4,16,-12
2015,1107,1318,14,14,0
2015,1112,1318,2,14,-12
2015,1116,1318,5,14,-9
2015,1124,1318,3,14,-11
2015,1125,1318,15,14,1
2015,1129,1318,11,14,-3
2015,1138,1318,12,14,-2
2015,1139,1318,6,14,-8
2015,1140,1318,11,14,-3
2015,1153,1318,8,14,-6
2015,1157,1318,16,14,2
2015,1172,1318,10,14,-4
2015,1173,1318,11,14,-3
2015,1181,1318,1,14,-13
2015,1186,1318,13,14,-1
2015,1207,1318,4,14,-10
2015,1208,1318,10,14,-4
2015,1209,1318,14,14,0
2015,1211,1318,2,14,-12
2015,1214,1318,16,14,2
2015,1217,1318,13,14,-1
2015,1231,1318,10,14,-4
2015,1234,1318,7,14,-7
2015,1235,1318,3,14,-11
2015,1242,1318,2,14,-12
2015,1246,1318,1,14,-13
2015,1248,1318,16,14,2
2015,1257,1318,4,14,-10
2015,1261,1318,9,14,-5
2015,1264,1318,16,14,2
2015,1268,1318,4,14,-10
2015,1277,1318,7,14,-7
2015,1279,1318,11,14,-3
2015,1295,1318,15,14,1
2015,1301,1318,8,14,-6
2015,1308,1318,15,14,1
2015,1314,1318,4,14,-10
2015,1316,1318,16,14,2
2015,1107,1320,14,5,9
2015,1112,1320,2,5,-3
2015,1116,1320,5,5,0
2015,1124,1320,3,5,-2
2015,1125,1320,15,5,10
2015,1129,1320,11,5,6
2015,1138,1320,12,5,7
2015,1139,1320,6,5,1
2015,1140,1320,11,5,6
2015,1153,1320,8,5,3
2015,1157,1320,16,5,11
2015,1172,1320,10,5,5
2015,1173,1320,11,5,6
2015,1181,1320,1,5,-4
2015,1186,1320,13,5,8
2015,1207,1320,4,5,-1
2015,1208,1320,10,5,5
2015,1209,1320,14,5,9
2015,1211,1320,2,5,-3
2015,1214,1320,16,5,11
2015,1217,1320,13,5,8
2015,1231,1320,10,5,5
2015,1234,1320,7,5,2
2015,1235,1320,3,5,-2
2015,1242,1320,2,5,-3
2015,1246,1320,1,5,-4
2015,1248,1320,16,5,11
2015,1257,1320,4,5,-1
2015,1261,1320,9,5,4
2015,1264,1320,16,5,11
2015,1268,1320,4,5,-1
2015,1277,1320,7,5,2
2015,1279,1320,11,5,6
2015,1295,1320,15,5,10
2015,1301,1320,8,5,3
2015,1308,1320,15,5,10
2015,1314,1320,4,5,-1
2015,1316,1320,16,5,11
2015,1318,1320,14,5,9
2015,1107,1323,14,3,11
2015,1112,1323,2,3,-1
2015,1116,1323,5,3,2
2015,1124,1323,3,3,0
2015,1125,1323,15,3,12
2015,1129,1323,11,3,8
2015,1138,1323,12,3,9
2015,1139,1323,6,3,3
2015,1140,1323,11,3,8
2015,1153,1323,8,3,5
2015,1157,1323,16,3,13
2015,1172,1323,10,3,7
2015,1173,1323,11,3,8
2015,1181,1323,1,3,-2
2015,1186,1323,13,3,10
2015,1207,1323,4,3,1
2015,1208,1323,10,3,7
2015,1209,1323,14,3,11
2015,1211,1323,2,3,-1
2015,1214,1323,16,3,13
2015,1217,1323,13,3,10
2015,1231,1323,10,3,7
2015,1234,1323,7,3,4
2015,1235,1323,3,3,0
2015,1242,1323,2,3,-1
2015,1246,1323,1,3,-2
2015,1248,1323,16,3,13
2015,1257,1323,4,3,1
2015,1261,1323,9,3,6
2015,1264,1323,16,3,13
2015,1268,1323,4,3,1
2015,1277,1323,7,3,4
2015,1279,1323,11,3,8
2015,1295,1323,15,3,12
2015,1301,1323,8,3,5
2015,1308,1323,15,3,12
2015,1314,1323,4,3,1
2015,1316,1323,16,3,13
2015,1318,1323,14,3,11
2015,1320,1323,5,3,2
2015,1107,1326,14,10,4
2015,1112,1326,2,10,-8
2015,1116,1326,5,10,-5
2015,1124,1326,3,10,-7
2015,1125,1326,15,10,5
2015,1129,1326,11,10,1
2015,1138,1326,12,10,2
2015,1139,1326,6,10,-4
2015,1140,1326,11,10,1
2015,1153,1326,8,10,-2
2015,1157,1326,16,10,6
2015,1172,1326,10,10,0
2015,1173,1326,11,10,1
2015,1181,1326,1,10,-9
2015,1186,1326,13,10,3
2015,1207,1326,4,10,-6
2015,1208,1326,10,10,0
2015,1209,1326,14,10,4
2015,1211,1326,2,10,-8
2015,1214,1326,16,10,6
2015,1217,1326,13,10,3
2015,1231,1326,10,10,0
2015,1234,1326,7,10,-3
2015,1235,1326,3,10,-7
2015,1242,1326,2,10,-8
2015,1246,1326,1,10,-9
2015,1248,1326,16,10,6
2015,1257,1326,4,10,-6
2015,1261,1326,9,10,-1
2015,1264,1326,16,10,6
2015,1268,1326,4,10,-6
2015,1277,1326,7,10,-3
2015,1279,1326,11,10,1
2015,1295,1326,15,10,5
2015,1301,1326,8,10,-2
2015,1308,1326,15,10,5
2015,1314,1326,4,10,-6
2015,1316,1326,16,10,6
2015,1318,1326,14,10,4
2015,1320,1326,5,10,-5
2015,1323,1326,3,10,-7
2015,1107,1328,14,3,11
2015,1112,1328,2,3,-1
2015,1116,1328,5,3,2
2015,1124,1328,3,3,0
2015,1125,1328,15,3,12
2015,1129,1328,11,3,8
2015,1138,1328,12,3,9
2015,1139,1328,6,3,3
2015,1140,1328,11,3,8
2015,1153,1328,8,3,5
2015,1157,1328,16,3,13
2015,1172,1328,10,3,7
2015,1173,1328,11,3,8
2015,1181,1328,1,3,-2
2015,1186,1328,13,3,10
2015,1207,1328,4,3,1
2015,1208,1328,10,3,7
2015,1209,1328,14,3,11
2015,1211,1328,2,3,-1
2015,1214,1328,16,3,13
2015,1217,1328,13,3,10
2015,1231,1328,10,3,7
2015,1234,1328,7,3,4
2015,1235,1328,3,3,0
2015,1242,1328,2,3,-1
2015,1246,1328,1,3,-2
2015,1248,1328,16,3,13
2015,1257,1328,4,3,1
2015,1261,1328,9,3,6
2015,1264,1328,16,3,13
2015,1268,1328,4,3,1
2015,1277,1328,7,3,4
2015,1279,1328,11,3,8
2015,1295,1328,15,3,12
2015,1301,1328,8,3,5
2015,1308,1328,15,3,12
2015,1314,1328,4,3,1
2015,1316,1328,16,3,13
2015,1318,1328,14,3,11
2015,1320,1328,5,3,2
2015,1323,1328,3,3,0
2015,1326,1328,10,3,7
2015,1107,1329,14,9,5
2015,1112,1329,2,9,-7
2015,1116,1329,5,9,-4
2015,1124,1329,3,9,-6
2015,1125,1329,15,9,6
2015,1129,1329,11,9,2
2015,1138,1329,12,9,3
2015,1139,1329,6,9,-3
2015,1140,1329,11,9,2
2015,1153,1329,8,9,-1
2015,1157,1329,16,9,7
2015,1172,1329,10,9,1
2015,1173,1329,11,9,2
2015,1181,1329,1,9,-8
2015,1186,1329,13,9,4
2015,1207,1329,4,9,-5
2015,1208,1329,10,9,1
2015,1209,1329,14,9,5
2015,1211,1329,2,9,-7
2015,1214,1329,16,9,7
2015,1217,1329,13,9,4
2015,1231,1329,10,9,1
2015,1234,1329,7,9,-2
2015,1235,1329,3,9,-6
2015,1242,1329,2,9,-7
2015,1246,1329,1,9,-8
2015,1248,1329,16,9,7
2015,1257,1329,4,9,-5
2015,1261,1329,9,9,0
2015,1264,1329,16,9,7
2015,1268,1329,4,9,-5
2015,1277,1329,7,9,-2
2015,1279,1329,11,9,2
2015,1295,1329,15,9,6
2015,1301,1329,8,9,-1
2015,1308,1329,15,9,6
2015,1314,1329,4,9,-5
2015,1316,1329,16,9,7
2015,1318,1329,14,9,5
2015,1320,1329,5,9,-4
2015,1323,1329,3,9,-6
2015,1326,1329,10,9,1
2015,1328,1329,3,9,-6
2015,1107,1332,14,8,6
2015,1112,1332,2,8,-6
2015,1116,1332,5,8,-3
2015,1124,1332,3,8,-5
2015,1125,1332,15,8,7
2015,1129,1332,11,8,3
2015,1138,1332,12,8,4
2015,1139,1332,6,8,-2
2015,1140,1332,11,8,3
2015,1153,1332,8,8,0
2015,1157,1332,16,8,8
2015,1172,1332,10,8,2
2015,1173,1332,11,8,3
2015,1181,1332,1,8,-7
2015,1186,1332,13,8,5
2015,1207,1332,4,8,-4
2015,1208,1332,10,8,2
2015,1209,1332,14,8,6
2015,1211,1332,2,8,-6
2015,1214,1332,16,8,8
2015,1217,1332,13,8,5
2015,1231,1332,10,8,2
2015,1234,1332,7,8,-1
2015,1235,1332,3,8,-5
2015,1242,1332,2,8,-6
2015,1246,1332,1,8,-7
2015,1248,1332,16,8,8
2015,1257,1332,4,8,-4
2015,1261,1332,9,8,1
2015,1264,1332,16,8,8
2015,1268,1332,4,8,-4
2015,1277,1332,7,8,-1
2015,1279,1332,11,8,3
2015,1295,1332,15,8,7
2015,1301,1332,8,8,0
2015,1308,1332,15,8,7
2015,1314,1332,4,8,-4
2015,1316,1332,16,8,8
2015,1318,1332,14,8,6
2015,1320,1332,5,8,-3
2015,1323,1332,3,8,-5
2015,1326,1332,10,8,2
2015,1328,1332,3,8,-5
2015,1329,1332,9,8,1
2015,1107,1344,14,6,8
2015,1112,1344,2,6,-4
2015,1116,1344,5,6,-1
2015,1124,1344,3,6,-3
2015,1125,1344,15,6,9
2015,1129,1344,11,6,5
2015,1138,1344,12,6,6
2015,1139,1344,6,6,0
2015,1140,1344,11,6,5
2015,1153,1344,8,6,2
2015,1157,1344,16,6,10
2015,1172,1344,10,6,4
2015,1173,1344,11,6,5
2015,1181,1344,1,6,-5
2015,1186,1344,13,6,7
2015,1207,1344,4,6,-2
2015,1208,1344,10,6,4
2015,1209,1344,14,6,8
2015,1211,1344,2,6,-4
2015,1214,1344,16,6,10
2015,1217,1344,13,6,7
2015,1231,1344,10,6,4
2015,1234,1344,7,6,1
2015,1235,1344,3,6,-3
2015,1242,1344,2,6,-4
2015,1246,1344,1,6,-5
2015,1248,1344,16,6,10
2015,1257,1344,4,6,-2
2015,1261,1344,9,6,3
2015,1264,1344,16,6,10
2015,1268,1344,4,6,-2
2015,1277,1344,7,6,1
2015,1279,1344,11,6,5
2015,1295,1344,15,6,9
2015,1301,1344,8,6,2
2015,1308,1344,15,6,9
2015,1314,1344,4,6,-2
2015,1316,1344,16,6,10
2015,1318,1344,14,6,8
2015,1320,1344,5,6,-1
2015,1323,1344,3,6,-3
2015,1326,1344,10,6,4
2015,1328,1344,3,6,-3
2015,1329,1344,9,6,3
2015,1332,1344,8,6,2
2015,1107,1345,14,9,5
2015,1112,1345,2,9,-7
2015,1116,1345,5,9,-4
2015,1124,1345,3,9,-6
2015,1125,1345,15,9,6
2015,1129,1345,11,9,2
2015,1138,1345,12,9,3
2015,1139,1345,6,9,-3
2015,1140,1345,11,9,2
2015,1153,1345,8,9,-1
2015,1157,1345,16,9,7
2015,1172,1345,10,9,1
2015,1173,1345,11,9,2
2015,1181,1345,1,9,-8
2015,1186,1345,13,9,4
2015,1207,1345,4,9,-5
2015,1208,1345,10,9,1
2015,1209,1345,14,9,5
2015,1211,1345,2,9,-7
2015,1214,1345,16,9,7
2015,1217,1345,13,9,4
2015,1231,1345,10,9,1
2015,1234,1345,7,9,-2
2015,1235,1345,3,9,-6
2015,1242,1345,2,9,-7
2015,1246,1345,1,9,-8
2015,1248,1345,16,9,7
2015,1257,1345,4,9,-5
2015,1261,1345,9,9,0
2015,1264,1345,16,9,7
2015,1268,1345,4,9,-5
2015,1277,1345,7,9,-2
2015,1279,1345,11,9,2
2015,1295,1345,15,9,6
2015,1301,1345,8,9,-1
2015,1308,1345,15,9,6
2015,1314,1345,4,9,-5
2015,1316,1345,16,9,7
2015,1318,1345,14,9,5
2015,1320,1345,5,9,-4
2015,1323,1345,3,9,-6
2015,1326,1345,10,9,1
2015,1328,1345,3,9,-6
2015,1329,1345,9,9,0
2015,1332,1345,8,9,-1
2015,1344,1345,6,9,-3
2015,1107,1352,14,16,-2
2015,1112,1352,2,16,-14
2015,1116,1352,5,16,-11
2015,1124,1352,3,16,-13
2015,1125,1352,15,16,-1
2015,1129,1352,11,16,-5
2015,1138,1352,12,16,-4
2015,1139,1352,6,16,-10
2015,1140,1352,11,16,-5
2015,1153,1352,8,16,-8
2015,1157,1352,16,16,0
2015,1172,1352,10,16,-6
2015,1173,1352,11,16,-5
2015,1181,1352,1,16,-15
2015,1186,1352,13,16,-3
2015,1207,1352,4,16,-12
2015,1208,1352,10,16,-6
2015,1209,1352,14,16,-2
2015,1211,1352,2,16,-14
2015,1214,1352,16,16,0
2015,1217,1352,13,16,-3
2015,1231,1352,10,16,-6
2015,1234,1352,7,16,-9
2015,1235,1352,3,16,-13
2015,1242,1352,2,16,-14
2015,1246,1352,1,16,-15
2015,1248,1352,16,16,0
2015,1257,1352,4,16,-12
2015,1261,1352,9,16,-7
2015,1264,1352,16,16,0
2015,1268,1352,4,16,-12
2015,1277,1352,7,16,-9
2015,1279,1352,11,16,-5
2015,1295,1352,15,16,-1
2015,1301,1352,8,16,-8
2015,1308,1352,15,16,-1
2015,1314,1352,4,16,-12
2015,1316,1352,16,16,0
2015,1318,1352,14,16,-2
2015,1320,1352,5,16,-11
2015,1323,1352,3,16,-13
2015,1326,1352,10,16,-6
2015,1328,1352,3,16,-13
2015,1329,1352,9,16,-7
2015,1332,1352,8,16,-8
2015,1344,1352,6,16,-10
2015,1345,1352,9,16,-7
2015,1107,1361,14,8,6
2015,1112,1361,2,8,-6
2015,1116,1361,5,8,-3
2015,1124,1361,3,8,-5
2015,1125,1361,15,8,7
2015,1129,1361,11,8,3
2015,1138,1361,12,8,4
2015,1139,1361,6,8,-2
2015,1140,1361,11,8,3
2015,1153,1361,8,8,0
2015,1157,1361,16,8,8
2015,1172,1361,10,8,2
2015,1173,1361,11,8,3
2015,1181,1361,1,8,-7
2015,1186,1361,13,8,5
2015,1207,1361,4,8,-4
2015,1208,1361,10,8,2
2015,1209,1361,14,8,6
2015,1211,1361,2,8,-6
2015,1214,1361,16,8,8
2015,1217,1361,13,8,5
2015,1231,1361,10,8,2
2015,1234,1361,7,8,-1
2015,1235,1361,3,8,-5
2015,1242,1361,2,8,-6
2015,1246,1361,1,8,-7
2015,1248,1361,16,8,8
2015,1257,1361,4,8,-4
2015,1261,1361,9,8,1
2015,1264,1361,16,8,8
2015,1268,1361,4,8,-4
2015,1277,1361,7,8,-1
2015,1279,1361,11,8,3
2015,1295,1361,15,8,7
2015,1301,1361,8,8,0
2015,1308,1361,15,8,7
2015,1314,1361,4,8,-4
2015,1316,1361,16,8,8
2015,1318,1361,14,8,6
2015,1320,1361,5,8,-3
2015,1323,1361,3,8,-5
2015,1326,1361,10,8,2
2015,1328,1361,3,8,-5
2015,1329,1361,9,8,1
2015,1332,1361,8,8,0
2015,1344,1361,6,8,-2
2015,1345,1361,9,8,1
2015,1352,1361,16,8,8
2015,1107,1372,14,12,2
2015,1112,1372,2,12,-10
2015,1116,1372,5,12,-7
2015,1124,1372,3,12,-9
2015,1125,1372,15,12,3
2015,1129,1372,11,12,-1
2015,1138,1372,12,12,0
2015,1139,1372,6,12,-6
2015,1140,1372,11,12,-1
2015,1153,1372,8,12,-4
2015,1157,1372,16,12,4
2015,1172,1372,10,12,-2
2015,1173,1372,11,12,-1
2015,1181,1372,1,12,-11
2015,1186,1372,13,12,1
2015,1207,1372,4,12,-8
2015,1208,1372,10,12,-2
2015,1209,1372,14,12,2
2015,1211,1372,2,12,-10
2015,1214,1372,16,12,4
2015,1217,1372,13,12,1
2015,1231,1372,10,12,-2
2015,1234,1372,7,12,-5
2015,1235,1372,3,12,-9
2015,1242,1372,2,12,-10
2015,1246,1372,1,12,-11
2015,1248,1372,16,12,4
2015,1257,1372,4,12,-8
2015,1261,1372,9,12,-3
2015,1264,1372,16,12,4
2015,1268,1372,4,12,-8
2015,1277,1372,7,12,-5
2015,1279,1372,11,12,-1
2015,1295,1372,15,12,3
2015,1301,1372,8,12,-4
2015,1308,1372,15,12,3
2015,1314,1372,4,12,-8
2015,1316,1372,16,12,4
2015,1318,1372,14,12,2
2015,1320,1372,5,12,-7
2015,1323,1372,3,12,-9
2015,1326,1372,10,12,-2
2015,1328,1372,3,12,-9
2015,1329,1372,9,12,-3
2015,1332,1372,8,12,-4
2015,1344,1372,6,12,-6
2015,1345,1372,9,12,-3
2015,1352,1372,16,12,4
2015,1361,1372,8,12,-4
2015,1107,1374,14,6,8
2015,1112,1374,2,6,-4
2015,1116,1374,5,6,-1
2015,1124,1374,3,6,-3
2015,1125,1374,15,6,9
2015,1129,1374,11,6,5
2015,1138,1374,12,6,6
2015,1139,1374,6,6,0
2015,1140,1374,11,6,5
2015,1153,1374,8,6,2
2015,1157,1374,16,6,10
2015,1172,1374,10,6,4
2015,1173,1374,11,6,5
2015,1181,1374,1,6,-5
2015,1186,1374,13,6,7
2015,1207,1374,4,6,-2
2015,1208,1374,10,6,4
2015,1209,1374,14,6,8
2015,1211,1374,2,6,-4
2015,1214,1374,16,6,10
2015,1217,1374,13,6,7
2015,1231,1374,10,6,4
2015,1234,1374,7,6,1
2015,1235,1374,3,6,-3
2015,1242,1374,2,6,-4
2015,1246,1374,1,6,-5
2015,1248,1374,16,6,10
2015,1257,1374,4,6,-2
2015,1261,1374,9,6,3
2015,1264,1374,16,6,10
2015,1268,1374,4,6,-2
2015,1277,1374,7,6,1
2015,1279,1374,11,6,5
2015,1295,1374,15,6,9
2015,1301,1374,8,6,2
2015,1308,1374,15,6,9
2015,1314,1374,4,6,-2
2015,1316,1374,16,6,10
2015,1318,1374,14,6,8
2015,1320,1374,5,6,-1
2015,1323,1374,3,6,-3
2015,1326,1374,10,6,4
2015,1328,1374,3,6,-3
2015,1329,1374,9,6,3
2015,1332,1374,8,6,2
2015,1344,1374,6,6,0
2015,1345,1374,9,6,3
2015,1352,1374,16,6,10
2015,1361,1374,8,6,2
2015,1372,1374,12,6,6
2015,1107,1385,14,9,5
2015,1112,1385,2,9,-7
2015,1116,1385,5,9,-4
2015,1124,1385,3,9,-6
2015,1125,1385,15,9,6
2015,1129,1385,11,9,2
2015,1138,1385,12,9,3
2015,1139,1385,6,9,-3
2015,1140,1385,11,9,2
2015,1153,1385,8,9,-1
2015,1157,1385,16,9,7
2015,1172,1385,10,9,1
2015,1173,1385,11,9,2
2015,1181,1385,1,9,-8
2015,1186,1385,13,9,4
2015,1207,1385,4,9,-5
2015,1208,1385,10,9,1
2015,1209,1385,14,9,5
2015,1211,1385,2,9,-7
2015,1214,1385,16,9,7
2015,1217,1385,13,9,4
2015,1231,1385,10,9,1
2015,1234,1385,7,9,-2
2015,1235,1385,3,9,-6
2015,1242,1385,2,9,-7
2015,1246,1385,1,9,-8
2015,1248,1385,16,9,7
2015,1257,1385,4,9,-5
2015,1261,1385,9,9,0
2015,1264,1385,16,9,7
2015,1268,1385,4,9,-5
2015,1277,1385,7,9,-2
2015,1279,1385,11,9,2
2015,1295,1385,15,9,6
2015,1301,1385,8,9,-1
2015,1308,1385,15,9,6
2015,1314,1385,4,9,-5
2015,1316,1385,16,9,7
2015,1318,1385,14,9,5
2015,1320,1385,5,9,-4
2015,1323,1385,3,9,-6
2015,1326,1385,10,9,1
2015,1328,1385,3,9,-6
2015,1329,1385,9,9,0
2015,1332,1385,8,9,-1
2015,1344,1385,6,9,-3
2015,1345,1385,9,9,0
2015,1352,1385,16,9,7
2015,1361,1385,8,9,-1
2015,1372,1385,12,9,3
2015,1374,1385,6,9,-3
2015,1107,1400,14,11,3
2015,1112,1400,2,11,-9
2015,1116,1400,5,11,-6
2015,1124,1400,3,11,-8
2015,1125,1400,15,11,4
2015,1129,1400,11,11,0
2015,1138,1400,12,11,1
2015,1139,1400,6,11,-5
2015,1140,1400,11,11,0
2015,1153,1400,8,11,-3
2015,1157,1400,16,11,5
2015,1172,1400,10,11,-1
2015,1173,1400,11,11,0
2015,1181,1400,1,11,-10
2015,1186,1400,13,11,2
2015,1207,1400,4,11,-7
2015,1208,1400,10,11,-1
2015,1209,1400,14,11,3
2015,1211,1400,2,11,-9
2015,1214,1400,16,11,5
2015,1217,1400,13,11,2
2015,1231,1400,10,11,-1
2015,1234,1400,7,11,-4
2015,1235,1400,3,11,-8
2015,1242,1400,2,11,-9
2015,1246,1400,1,11,-10
2015,1248,1400,16,11,5
2015,1257,1400,4,11,-7
2015,1261,1400,9,11,-2
2015,1264,1400,16,11,5
2015,1268,1400,4,11,-7
2015,1277,1400,7,11,-4
2015,1279,1400,11,11,0
2015,1295,1400,15,11,4
2015,1301,1400,8,11,-3
2015,1308,1400,15,11,4
2015,1314,1400,4,11,-7
2015,1316,1400,16,11,5
2015,1318,1400,14,11,3
2015,1320,1400,5,11,-6
2015,1323,1400,3,11,-8
2015,1326,1400,10,11,-1
2015,1328,1400,3,11,-8
2015,1329,1400,9,11,-2
2015,1332,1400,8,11,-3
2015,1344,1400,6,11,-5
2015,1345,1400,9,11,-2
2015,1352,1400,16,11,5
2015,1361,1400,8,11,-3
2015,1372,1400,12,11,1
2015,1374,1400,6,11,-5
2015,1385,1400,9,11,-2
2015,1107,1411,14,15,-1
2015,1112,1411,2,15,-13
2015,1116,1411,5,15,-10
2015,1124,1411,3,15,-12
2015,1125,1411,15,15,0
2015,1129,1411,11,15,-4
2015,1138,1411,12,15,-3
2015,1139,1411,6,15,-9
2015,1140,1411,11,15,-4
2015,1153,1411,8,15,-7
2015,1157,1411,16,15,1
2015,1172,1411,10,15,-5
2015,1173,1411,11,15,-4
2015,1181,1411,1,15,-14
2015,1186,1411,13,15,-2
2015,1207,1411,4,15,-11
2015,1208,1411,10,15,-5
2015,1209,1411,14,15,-1
2015,1211,1411,2,15,-13
2015,1214,1411,16,15,1
2015,1217,1411,13,15,-2
2015,1231,1411,10,15,-5
2015,1234,1411,7,15,-8
2015,1235,1411,3,15,-12
2015,1242,1411,2,15,-13
2015,1246,1411,1,15,-14
2015,1248,1411,16,15,1
2015,1257,1411,4,15,-11
2015,1261,1411,9,15,-6
2015,1264,1411,16,15,1
2015,1268,1411,4,15,-11
2015,1277,1411,7,15,-8
2015,1279,1411,11,15,-4
2015,1295,1411,15,15,0
2015,1301,1411,8,15,-7
2015,1308,1411,15,15,0
2015,1314,1411,4,15,-11
2015,1316,1411,16,15,1
2015,1318,1411,14,15,-1
2015,1320,1411,5,15,-10
2015,1323,1411,3,15,-12
2015,1326,1411,10,15,-5
2015,1328,1411,3,15,-12
2015,1329,1411,9,15,-6
2015,1332,1411,8,15,-7
2015,1344,1411,6,15,-9
2015,1345,1411,9,15,-6
2015,1352,1411,16,15,1
2015,1361,1411,8,15,-7
2015,1372,1411,12,15,-3
2015,1374,1411,6,15,-9
2015,1385,1411,9,15,-6
2015,1400,1411,11,15,-4
2015,1107,1412,14,14,0
2015,1112,1412,2,14,-12
2015,1116,1412,5,14,-9
2015,1124,1412,3,14,-11
2015,1125,1412,15,14,1
2015,1129,1412,11,14,-3
2015,1138,1412,12,14,-2
2015,1139,1412,6,14,-8
2015,1140,1412,11,14,-3
2015,1153,1412,8,14,-6
2015,1157,1412,16,14,2
2015,1172,1412,10,14,-4
2015,1173,1412,11,14,-3
2015,1181,1412,1,14,-13
2015,1186,1412,13,14,-1
2015,1207,1412,4,14,-10
2015,1208,1412,10,14,-4
2015,1209,1412,14,14,0
2015,1211,1412,2,14,-12
2015,1214,1412,16,14,2
2015,1217,1412,13,14,-1
2015,1231,1412,10,14,-4
2015,1234,1412,7,14,-7
2015,1235,1412,3,14,-11
2015,1242,1412,2,14,-12
2015,1246,1412,1,14,-13
2015,1248,1412,16,14,2
2015,1257,1412,4,14,-10
2015,1261,1412,9,14,-5
2015,1264,1412,16,14,2
2015,1268,1412,4,14,-10
2015,1277,1412,7,14,-7
2015,1279,1412,11,14,-3
2015,1295,1412,15,14,1
2015,1301,1412,8,14,-6
2015,1308,1412,15,14,1
2015,1314,1412,4,14,-10
2015,1316,1412,16,14,2
2015,1318,1412,14,14,0
2015,1320,1412,5,14,-9
2015,1323,1412,3,14,-11
2015,1326,1412,10,14,-4
2015,1328,1412,3,14,-11
2015,1329,1412,9,14,-5
2015,1332,1412,8,14,-6
2015,1344,1412,6,14,-8
2015,1345,1412,9,14,-5
2015,1352,1412,16,14,2
2015,1361,1412,8,14,-6
2015,1372,1412,12,14,-2
2015,1374,1412,6,14,-8
2015,1385,1412,9,14,-5
2015,1400,1412,11,14,-3
2015,1411,1412,15,14,1
2015,1107,1414,14,13,1
2015,1112,1414,2,13,-11
2015,1116,1414,5,13,-8
2015,1124,1414,3,13,-10
2015,1125,1414,15,13,2
2015,1129,1414,11,13,-2
2015,1138,1414,12,13,-1
2015,1139,1414,6,13,-7
2015,1140,1414,11,13,-2
2015,1153,1414,8,13,-5
2015,1157,1414,16,13,3
2015,1172,1414,10,13,-3
2015,1173,1414,11,13,-2
2015,1181,1414,1,13,-12
2015,1186,1414,13,13,0
2015,1207,1414,4,13,-9
2015,1208,1414,10,13,-3
2015,1209,1414,14,13,1
2015,1211,1414,2,13,-11
2015,1214,1414,16,13,3
2015,1217,1414,13,13,0
2015,1231,1414,10,13,-3
2015,1234,1414,7,13,-6
2015,1235,1414,3,13,-10
2015,1242,1414,2,13,-11
2015,1246,1414,1,13,-12
2015,1248,1414,16,13,3
2015,1257,1414,4,13,-9
2015,1261,1414,9,13,-4
2015,1264,1414,16,13,3
2015,1268,1414,4,13,-9
2015,1277,1414,7,13,-6
2015,1279,1414,11,13,-2
2015,1295,1414,15,13,2
2015,1301,1414,8,13,-5
2015,1308,1414,15,13,2
2015,1314,1414,4,13,-9
2015,1316,1414,16,13,3
2015,1318,1414,14,13,1
2015,1320,1414,5,13,-8
2015,1323,1414,3,13,-10
2015,1326,1414,10,13,-3
2015,1328,1414,3,13,-10
2015,1329,1414,9,13,-4
2015,1332,1414,8,13,-5
2015,1344,1414,6,13,-7
2015,1345,1414,9,13,-4
2015,1352,1414,16,13,3
2015,1361,1414,8,13,-5
2015,1372,1414,12,13,-1
2015,1374,1414,6,13,-7
2015,1385,1414,9,13,-4
2015,1400,1414,11,13,-2
2015,1411,1414,15,13,2
2015,1412,1414,14,13,1
2015,1107,1417,14,11,3
2015,1112,1417,2,11,-9
2015,1116,1417,5,11,-6
2015,1124,1417,3,11,-8
2015,1125,1417,15,11,4
2015,1129,1417,11,11,0
2015,1138,1417,12,11,1
2015,1139,1417,6,11,-5
2015,1140,1417,11,11,0
2015,1153,1417,8,11,-3
2015,1157,1417,16,11,5
2015,1172,1417,10,11,-1
2015,1173,1417,11,11,0
2015,1181,1417,1,11,-10
2015,1186,1417,13,11,2
2015,1207,1417,4,11,-7
2015,1208,1417,10,11,-1
2015,1209,1417,14,11,3
2015,1211,1417,2,11,-9
2015,1214,1417,16,11,5
2015,1217,1417,13,11,2
2015,1231,1417,10,11,-1
2015,1234,1417,7,11,-4
2015,1235,1417,3,11,-8
2015,1242,1417,2,11,-9
2015,1246,1417,1,11,-10
2015,1248,1417,16,11,5
2015,1257,1417,4,11,-7
2015,1261,1417,9,11,-2
2015,1264,1417,16,11,5
2015,1268,1417,4,11,-7
2015,1277,1417,7,11,-4
2015,1279,1417,11,11,0
2015,1295,1417,15,11,4
2015,1301,1417,8,11,-3
2015,1308,1417,15,11,4
2015,1314,1417,4,11,-7
2015,1316,1417,16,11,5
2015,1318,1417,14,11,3
2015,1320,1417,5,11,-6
2015,1323,1417,3,11,-8
2015,1326,1417,10,11,-1
2015,1328,1417,3,11,-8
2015,1329,1417,9,11,-2
2015,1332,1417,8,11,-3
2015,1344,1417,6,11,-5
2015,1345,1417,9,11,-2
2015,1352,1417,16,11,5
2015,1361,1417,8,11,-3
2015,1372,1417,12,11,1
2015,1374,1417,6,11,-5
2015,1385,1417,9,11,-2
2015,1400,1417,11,11,0
2015,1411,1417,15,11,4
2015,1412,1417,14,11,3
2015,1414,1417,13,11,2
2015,1107,1428,14,5,9
2015,1112,1428,2,5,-3
2015,1116,1428,5,5,0
2015,1124,1428,3,5,-2
2015,1125,1428,15,5,10
2015,1129,1428,11,5,6
2015,1138,1428,12,5,7
2015,1139,1428,6,5,1
2015,1140,1428,11,5,6
2015,1153,1428,8,5,3
2015,1157,1428,16,5,11
2015,1172,1428,10,5,5
2015,1173,1428,11,5,6
2015,1181,1428,1,5,-4
2015,1186,1428,13,5,8
2015,1207,1428,4,5,-1
2015,1208,1428,10,5,5
2015,1209,1428,14,5,9
2015,1211,1428,2,5,-3
2015,1214,1428,16,5,11
2015,1217,1428,13,5,8
2015,1231,1428,10,5,5
2015,1234,1428,7,5,2
2015,1235,1428,3,5,-2
2015,1242,1428,2,5,-3
2015,1246,1428,1,5,-4
2015,1248,1428,16,5,11
2015,1257,1428,4,5,-1
2015,1261,1428,9,5,4
2015,1264,1428,16,5,11
2015,1268,1428,4,5,-1
2015,1277,1428,7,5,2
2015,1279,1428,11,5,6
2015,1295,1428,15,5,10
2015,1301,1428,8,5,3
2015,1308,1428,15,5,10
2015,1314,1428,4,5,-1
2015,1316,1428,16,5,11
2015,1318,1428,14,5,9
2015,1320,1428,5,5,0
2015,1323,1428,3,5,-2
2015,1326,1428,10,5,5
2015,1328,1428,3,5,-2
2015,1329,1428,9,5,4
2015,1332,1428,8,5,3
2015,1344,1428,6,5,1
2015,1345,1428,9,5,4
2015,1352,1428,16,5,11
2015,1361,1428,8,5,3
2015,1372,1428,12,5,7
2015,1374,1428,6,5,1
2015,1385,1428,9,5,4
2015,1400,1428,11,5,6
2015,1411,1428,15,5,10
2015,1412,1428,14,5,9
2015,1414,1428,13,5,8
2015,1417,1428,11,5,6
2015,1107,1433,14,7,7
2015,1112,1433,2,7,-5
2015,1116,1433,5,7,-2
2015,1124,1433,3,7,-4
2015,1125,1433,15,7,8
2015,1129,1433,11,7,4
2015,1138,1433,12,7,5
2015,1139,1433,6,7,-1
2015,1140,1433,11,7,4
2015,1153,1433,8,7,1
2015,1157,1433,16,7,9
2015,1172,1433,10,7,3
2015,1173,1433,11,7,4
2015,1181,1433,1,7,-6
2015,1186,1433,13,7,6
2015,1207,1433,4,7,-3
2015,1208,1433,10,7,3
2015,1209,1433,14,7,7
2015,1211,1433,2,7,-5
2015,1214,1433,16,7,9
2015,1217,1433,13,7,6
2015,1231,1433,10,7,3
2015,1234,1433,7,7,0
2015,1235,1433,3,7,-4
2015,1242,1433,2,7,-5
2015,1246,1433,1,7,-6
2015,1248,1433,16,7,9
2015,1257,1433,4,7,-3
2015,1261,1433,9,7,2
2015,1264,1433,16,7,9
2015,1268,1433,4,7,-3
2015,1277,1433,7,7,0
2015,1279,1433,11,7,4
2015,1295,1433,15,7,8
2015,1301,1433,8,7,1
2015,1308,1433,15,7,8
2015,1314,1433,4,7,-3
2015,1316,1433,16,7,9
2015,1318,1433,14,7,7
2015,1320,1433,5,7,-2
2015,1323,1433,3,7,-4
2015,1326,1433,10,7,3
2015,1328,1433,3,7,-4
2015,1329,1433,9,7,2
2015,1332,1433,8,7,1
2015,1344,1433,6,7,-1
2015,1345,1433,9,7,2
2015,1352,1433,16,7,9
2015,1361,1433,8,7,1
2015,1372,1433,12,7,5
2015,1374,1433,6,7,-1
2015,1385,1433,9,7,2
2015,1400,1433,11,7,4
2015,1411,1433,15,7,8
2015,1412,1433,14,7,7
2015,1414,1433,13,7,6
2015,1417,1433,11,7,4
2015,1428,1433,5,7,-2
2015,1107,1434,14,13,1
2015,1112,1434,2,13,-11
2015,1116,1434,5,13,-8
2015,1124,1434,3,13,-10
2015,1125,1434,15,13,2
2015,1129,1434,11,13,-2
2015,1138,1434,12,13,-1
2015,1139,1434,6,13,-7
2015,1140,1434,11,13,-2
2015,1153,1434,8,13,-5
2015,1157,1434,16,13,3
2015,1172,1434,10,13,-3
2015,1173,1434,11,13,-2
2015,1181,1434,1,13,-12
2015,1186,1434,13,13,0
2015,1207,1434,4,13,-9
2015,1208,1434,10,13,-3
2015,1209,1434,14,13,1
2015,1211,1434,2,13,-11
2015,1214,1434,16,13,3
2015,1217,1434,13,13,0
2015,1231,1434,10,13,-3
2015,1234,1434,7,13,-6
2015,1235,1434,3,13,-10
2015,1242,1434,2,13,-11
2015,1246,1434,1,13,-12
2015,1248,1434,16,13,3
2015,1257,1434,4,13,-9
2015,1261,1434,9,13,-4
2015,1264,1434,16,13,3
2015,1268,1434,4,13,-9
2015,1277,1434,7,13,-6
2015,1279,1434,11,13,-2
2015,1295,1434,15,13,2
2015,1301,1434,8,13,-5
2015,1308,1434,15,13,2
2015,1314,1434,4,13,-9
2015,1316,1434,16,13,3
2015,1318,1434,14,13,1
2015,1320,1434,5,13,-8
2015,1323,1434,3,13,-10
2015,1326,1434,10,13,-3
2015,1328,1434,3,13,-10
2015,1329,1434,9,13,-4
2015,1332,1434,8,13,-5
2015,1344,1434,6,13,-7
2015,1345,1434,9,13,-4
2015,1352,1434,16,13,3
2015,1361,1434,8,13,-5
2015,1372,1434,12,13,-1
2015,1374,1434,6,13,-7
2015,1385,1434,9,13,-4
2015,1400,1434,11,13,-2
2015,1411,1434,15,13,2
2015,1412,1434,14,13,1
2015,1414,1434,13,13,0
2015,1417,1434,11,13,-2
2015,1428,1434,5,13,-8
2015,1433,1434,7,13,-6
2015,1107,1437,14,1,13
2015,1112,1437,2,1,1
2015,1116,1437,5,1,4
2015,1124,1437,3,1,2
2015,1125,1437,15,1,14
2015,1129,1437,11,1,10
2015,1138,1437,12,1,11
2015,1139,1437,6,1,5
2015,1140,1437,11,1,10
2015,1153,1437,8,1,7
2015,1157,1437,16,1,15
2015,1172,1437,10,1,9
2015,1173,1437,11,1,10
2015,1181,1437,1,1,0
2015,1186,1437,13,1,12
2015,1207,1437,4,1,3
2015,1208,1437,10,1,9
2015,1209,1437,14,1,13
2015,1211,1437,2,1,1
2015,1214,1437,16,1,15
2015,1217,1437,13,1,12
2015,1231,1437,10,1,9
2015,1234,1437,7,1,6
2015,1235,1437,3,1,2
2015,1242,1437,2,1,1
2015,1246,1437,1,1,0
2015,1248,1437,16,1,15
2015,1257,1437,4,1,3
2015,1261,1437,9,1,8
2015,1264,1437,16,1,15
2015,1268,1437,4,1,3
2015,1277,1437,7,1,6
2015,1279,1437,11,1,10
2015,1295,1437,15,1,14
2015,1301,1437,8,1,7
2015,1308,1437,15,1,14
2015,1314,1437,4,1,3
2015,1316,1437,16,1,15
2015,1318,1437,14,1,13
2015,1320,1437,5,1,4
2015,1323,1437,3,1,2
2015,1326,1437,10,1,9
2015,1328,1437,3,1,2
2015,1329,1437,9,1,8
2015,1332,1437,8,1,7
2015,1344,1437,6,1,5
2015,1345,1437,9,1,8
2015,1352,1437,16,1,15
2015,1361,1437,8,1,7
2015,1372,1437,12,1,11
2015,1374,1437,6,1,5
2015,1385,1437,9,1,8
2015,1400,1437,11,1,10
2015,1411,1437,15,1,14
2015,1412,1437,14,1,13
2015,1414,1437,13,1,12
2015,1417,1437,11,1,10
2015,1428,1437,5,1,4
2015,1433,1437,7,1,6
2015,1434,1437,13,1,12
2015,1107,1438,14,2,12
2015,1112,1438,2,2,0
2015,1116,1438,5,2,3
2015,1124,1438,3,2,1
2015,1125,1438,15,2,13
2015,1129,1438,11,2,9
2015,1138,1438,12,2,10
2015,1139,1438,6,2,4
2015,1140,1438,11,2,9
2015,1153,1438,8,2,6
2015,1157,1438,16,2,14
2015,1172,1438,10,2,8
2015,1173,1438,11,2,9
2015,1181,1438,1,2,-1
2015,1186,1438,13,2,11
2015,1207,1438,4,2,2
2015,1208,1438,10,2,8
2015,1209,1438,14,2,12
2015,1211,1438,2,2,0
2015,1214,1438,16,2,14
2015,1217,1438,13,2,11
2015,1231,1438,10,2,8
2015,1234,1438,7,2,5
2015,1235,1438,3,2,1
2015,1242,1438,2,2,0
2015,1246,1438,1,2,-1
2015,1248,1438,16,2,14
2015,1257,1438,4,2,2
2015,1261,1438,9,2,7
2015,1264,1438,16,2,14
2015,1268,1438,4,2,2
2015,1277,1438,7,2,5
2015,1279,1438,11,2,9
2015,1295,1438,15,2,13
2015,1301,1438,8,2,6
2015,1308,1438,15,2,13
2015,1314,1438,4,2,2
2015,1316,1438,16,2,14
2015,1318,1438,14,2,12
2015,1320,1438,5,2,3
2015,1323,1438,3,2,1
2015,1326,1438,10,2,8
2015,1328,1438,3,2,1
2015,1329,1438,9,2,7
2015,1332,1438,8,2,6
2015,1344,1438,6,2,4
2015,1345,1438,9,2,7
2015,1352,1438,16,2,14
2015,1361,1438,8,2,6
2015,1372,1438,12,2,10
2015,1374,1438,6,2,4
2015,1385,1438,9,2,7
2015,1400,1438,11,2,9
2015,1411,1438,15,2,13
2015,1412,1438,14,2,12
2015,1414,1438,13,2,11
2015,1417,1438,11,2,9
2015,1428,1438,5,2,3
2015,1433,1438,7,2,5
2015,1434,1438,13,2,11
2015,1437,1438,1,2,-1
2015,1107,1452,14,5,9
2015,1112,1452,2,5,-3
2015,1116,1452,5,5,0
2015,1124,1452,3,5,-2
2015,1125,1452,15,5,10
2015,1129,1452,11,5,6
2015,1138,1452,12,5,7
2015,1139,1452,6,5,1
2015,1140,1452,11,5,6
2015,1153,1452,8,5,3
2015,1157,1452,16,5,11
2015,1172,1452,10,5,5
2015,1173,1452,11,5,6
2015,1181,1452,1,5,-4
2015,1186,1452,13,5,8
2015,1207,1452,4,5,-1
2015,1208,1452,10,5,5
2015,1209,1452,14,5,9
2015,1211,1452,2,5,-3
2015,1214,1452,16,5,11
2015,1217,1452,13,5,8
2015,1231,1452,10,5,5
2015,1234,1452,7,5,2
2015,1235,1452,3,5,-2
2015,1242,1452,2,5,-3
2015,1246,1452,1,5,-4
2015,1248,1452,16,5,11
2015,1257,1452,4,5,-1
2015,1261,1452,9,5,4
2015,1264,1452,16,5,11
2015,1268,1452,4,5,-1
2015,1277,1452,7,5,2
2015,1279,1452,11,5,6
2015,1295,1452,15,5,10
2015,1301,1452,8,5,3
2015,1308,1452,15,5,10
2015,1314,1452,4,5,-1
2015,1316,1452,16,5,11
2015,1318,1452,14,5,9
2015,1320,1452,5,5,0
2015,1323,1452,3,5,-2
2015,1326,1452,10,5,5
2015,1328,1452,3,5,-2
2015,1329,1452,9,5,4
2015,1332,1452,8,5,3
2015,1344,1452,6,5,1
2015,1345,1452,9,5,4
2015,1352,1452,16,5,11
2015,1361,1452,8,5,3
2015,1372,1452,12,5,7
2015,1374,1452,6,5,1
2015,1385,1452,9,5,4
2015,1400,1452,11,5,6
2015,1411,1452,15,5,10
2015,1412,1452,14,5,9
2015,1414,1452,13,5,8
2015,1417,1452,11,5,6
2015,1428,1452,5,5,0
2015,1433,1452,7,5,2
2015,1434,1452,13,5,8
2015,1437,1452,1,5,-4
2015,1438,1452,2,5,-3
2015,1107,1455,14,7,7
2015,1112,1455,2,7,-5
2015,1116,1455,5,7,-2
2015,1124,1455,3,7,-4
2015,1125,1455,15,7,8
2015,1129,1455,11,7,4
2015,1138,1455,12,7,5
2015,1139,1455,6,7,-1
2015,1140,1455,11,7,4
2015,1153,1455,8,7,1
2015,1157,1455,16,7,9
2015,1172,1455,10,7,3
2015,1173,1455,11,7,4
2015,1181,1455,1,7,-6
2015,1186,1455,13,7,6
2015,1207,1455,4,7,-3
2015,1208,1455,10,7,3
2015,1209,1455,14,7,7
2015,1211,1455,2,7,-5
2015,1214,1455,16,7,9
2015,1217,1455,13,7,6
2015,1231,1455,10,7,3
2015,1234,1455,7,7,0
2015,1235,1455,3,7,-4
2015,1242,1455,2,7,-5
2015,1246,1455,1,7,-6
2015,1248,1455,16,7,9
2015,1257,1455,4,7,-3
2015,1261,1455,9,7,2
2015,1264,1455,16,7,9
2015,1268,1455,4,7,-3
2015,1277,1455,7,7,0
2015,1279,1455,11,7,4
2015,1295,1455,15,7,8
2015,1301,1455,8,7,1
2015,1308,1455,15,7,8
2015,1314,1455,4,7,-3
2015,1316,1455,16,7,9
2015,1318,1455,14,7,7
2015,1320,1455,5,7,-2
2015,1323,1455,3,7,-4
2015,1326,1455,10,7,3
2015,1328,1455,3,7,-4
2015,1329,1455,9,7,2
2015,1332,1455,8,7,1
2015,1344,1455,6,7,-1
2015,1345,1455,9,7,2
2015,1352,1455,16,7,9
2015,1361,1455,8,7,1
2015,1372,1455,12,7,5
2015,1374,1455,6,7,-1
2015,1385,1455,9,7,2
2015,1400,1455,11,7,4
2015,1411,1455,15,7,8
2015,1412,1455,14,7,7
2015,1414,1455,13,7,6
2015,1417,1455,11,7,4
2015,1428,1455,5,7,-2
2015,1433,1455,7,7,0
2015,1434,1455,13,7,6
2015,1437,1455,1,7,-6
2015,1438,1455,2,7,-5
2015,1452,1455,5,7,-2
2015,1107,1458,14,1,13
2015,1112,1458,2,1,1
2015,1116,1458,5,1,4
2015,1124,1458,3,1,2
2015,1125,1458,15,1,14
2015,1129,1458,11,1,10
2015,1138,1458,12,1,11
2015,1139,1458,6,1,5
2015,1140,1458,11,1,10
2015,1153,1458,8,1,7
2015,1157,1458,16,1,15
2015,1172,1458,10,1,9
2015,1173,1458,11,1,10
2015,1181,1458,1,1,0
2015,1186,1458,13,1,12
2015,1207,1458,4,1,3
2015,1208,1458,10,1,9
2015,1209,1458,14,1,13
2015,1211,1458,2,1,1
2015,1214,1458,16,1,15
2015,1217,1458,13,1,12
2015,1231,1458,10,1,9
2015,1234,1458,7,1,6
2015,1235,1458,3,1,2
2015,1242,1458,2,1,1
2015,1246,1458,1,1,0
2015,1248,1458,16,1,15
2015,1257,1458,4,1,3
2015,1261,1458,9,1,8
2015,1264,1458,16,1,15
2015,1268,1458,4,1,3
2015,1277,1458,7,1,6
2015,1279,1458,11,1,10
2015,1295,1458,15,1,14
2015,1301,1458,8,1,7
2015,1308,1458,15,1,14
2015,1314,1458,4,1,3
2015,1316,1458,16,1,15
2015,1318,1458,14,1,13
2015,1320,1458,5,1,4
2015,1323,1458,3,1,2
2015,1326,1458,10,1,9
2015,1328,1458,3,1,2
2015,1329,1458,9,1,8
2015,1332,1458,8,1,7
2015,1344,1458,6,1,5
2015,1345,1458,9,1,8
2015,1352,1458,16,1,15
2015,1361,1458,8,1,7
2015,1372,1458,12,1,11
2015,1374,1458,6,1,5
2015,1385,1458,9,1,8
2015,1400,1458,11,1,10
2015,1411,1458,15,1,14
2015,1412,1458,14,1,13
2015,1414,1458,13,1,12
2015,1417,1458,11,1,10
2015,1428,1458,5,1,4
2015,1433,1458,7,1,6
2015,1434,1458,13,1,12
2015,1437,1458,1,1,0
2015,1438,1458,2,1,1
2015,1452,1458,5,1,4
2015,1455,1458,7,1,6
2015,1107,1459,14,12,2
2015,1112,1459,2,12,-10
2015,1116,1459,5,12,-7
2015,1124,1459,3,12,-9
2015,1125,1459,15,12,3
2015,1129,1459,11,12,-1
2015,1138,1459,12,12,0
2015,1139,1459,6,12,-6
2015,1140,1459,11,12,-1
2015,1153,1459,8,12,-4
2015,1157,1459,16,12,4
2015,1172,1459,10,12,-2
2015,1173,1459,11,12,-1
2015,1181,1459,1,12,-11
2015,1186,1459,13,12,1
2015,1207,1459,4,12,-8
2015,1208,1459,10,12,-2
2015,1209,1459,14,12,2
2015,1211,1459,2,12,-10
2015,1214,1459,16,12,4
2015,1217,1459,13,12,1
2015,1231,1459,10,12,-2
2015,1234,1459,7,12,-5
2015,1235,1459,3,12,-9
2015,1242,1459,2,12,-10
2015,1246,1459,1,12,-11
2015,1248,1459,16,12,4
2015,1257,1459,4,12,-8
2015,1261,1459,9,12,-3
2015,1264,1459,16,12,4
2015,1268,1459,4,12,-8
2015,1277,1459,7,12,-5
2015,1279,1459,11,12,-1
2015,1295,1459,15,12,3
2015,1301,1459,8,12,-4
2015,1308,1459,15,12,3
2015,1314,1459,4,12,-8
2015,1316,1459,16,12,4
2015,1318,1459,14,12,2
2015,1320,1459,5,12,-7
2015,1323,1459,3,12,-9
2015,1326,1459,10,12,-2
2015,1328,1459,3,12,-9
2015,1329,1459,9,12,-3
2015,1332,1459,8,12,-4
2015,1344,1459,6,12,-6
2015,1345,1459,9,12,-3
2015,1352,1459,16,12,4
2015,1361,1459,8,12,-4
2015,1372,1459,12,12,0
2015,1374,1459,6,12,-6
2015,1385,1459,9,12,-3
2015,1400,1459,11,12,-1
2015,1411,1459,15,12,3
2015,1412,1459,14,12,2
2015,1414,1459,13,12,1
2015,1417,1459,11,12,-1
2015,1428,1459,5,12,-7
2015,1433,1459,7,12,-5
2015,1434,1459,13,12,1
2015,1437,1459,1,12,-11
2015,1438,1459,2,12,-10
2015,1452,1459,5,12,-7
2015,1455,1459,7,12,-5
2015,1458,1459,1,12,-11
2015,1107,1461,14,12,2
2015,1112,1461,2,12,-10
2015,1116,1461,5,12,-7
2015,1124,1461,3,12,-9
2015,1125,1461,15,12,3
2015,1129,1461,11,12,-1
2015,1138,1461,12,12,0
2015,1139,1461,6,12,-6
2015,1140,1461,11,12,-1
2015,1153,1461,8,12,-4
2015,1157,1461,16,12,4
2015,1172,1461,10,12,-2
2015,1173,1461,11,12,-1
2015,1181,1461,1,12,-11
2015,1186,1461,13,12,1
2015,1207,1461,4,12,-8
2015,1208,1461,10,12,-2
2015,1209,1461,14,12,2
2015,1211,1461,2,12,-10
2015,1214,1461,16,12,4
2015,1217,1461,13,12,1
2015,1231,1461,10,12,-2
2015,1234,1461,7,12,-5
2015,1235,1461,3,12,-9
2015,1242,1461,2,12,-10
2015,1246,1461,1,12,-11
2015,1248,1461,16,12,4
2015,1257,1461,4,12,-8
2015,1261,1461,9,12,-3
2015,1264,1461,16,12,4
2015,1268,1461,4,12,-8
2015,1277,1461,7,12,-5
2015,1279,1461,11,12,-1
2015,1295,1461,15,12,3
2015,1301,1461,8,12,-4
2015,1308,1461,15,12,3
2015,1314,1461,4,12,-8
2015,1316,1461,16,12,4
2015,1318,1461,14,12,2
2015,1320,1461,5,12,-7
2015,1323,1461,3,12,-9
2015,1326,1461,10,12,-2
2015,1328,1461,3,12,-9
2015,1329,1461,9,12,-3
2015,1332,1461,8,12,-4
2015,1344,1461,6,12,-6
2015,1345,1461,9,12,-3
2015,1352,1461,16,12,4
2015,1361,1461,8,12,-4
2015,1372,1461,12,12,0
2015,1374,1461,6,12,-6
2015,1385,1461,9,12,-3
2015,1400,1461,11,12,-1
2015,1411,1461,15,12,3
2015,1412,1461,14,12,2
2015,1414,1461,13,12,1
2015,1417,1461,11,12,-1
2015,1428,1461,5,12,-7
2015,1433,1461,7,12,-5
2015,1434,1461,13,12,1
2015,1437,1461,1,12,-11
2015,1438,1461,2,12,-10
2015,1452,1461,5,12,-7
2015,1455,1461,7,12,-5
2015,1458,1461,1,12,-11
2015,1459,1461,12,12,0
2015,1107,1462,14,6,8
2015,1112,1462,2,6,-4
2015,1116,1462,5,6,-1
2015,1124,1462,3,6,-3
2015,1125,1462,15,6,9
2015,1129,1462,11,6,5
2015,1138,1462,12,6,6
2015,1139,1462,6,6,0
2015,1140,1462,11,6,5
2015,1153,1462,8,6,2
2015,1157,1462,16,6,10
2015,1172,1462,10,6,4
2015,1173,1462,11,6,5
2015,1181,1462,1,6,-5
2015,1186,1462,13,6,7
2015,1207,1462,4,6,-2
2015,1208,1462,10,6,4
2015,1209,1462,14,6,8
2015,1211,1462,2,6,-4
2015,1214,1462,16,6,10
2015,1217,1462,13,6,7
2015,1231,1462,10,6,4
2015,1234,1462,7,6,1
2015,1235,1462,3,6,-3
2015,1242,1462,2,6,-4
2015,1246,1462,1,6,-5
2015,1248,1462,16,6,10
2015,1257,1462,4,6,-2
2015,1261,1462,9,6,3
2015,1264,1462,16,6,10
2015,1268,1462,4,6,-2
2015,1277,1462,7,6,1
2015,1279,1462,11,6,5
2015,1295,1462,15,6,9
2015,1301,1462,8,6,2
2015,1308,1462,15,6,9
2015,1314,1462,4,6,-2
2015,1316,1462,16,6,10
2015,1318,1462,14,6,8
2015,1320,1462,5,6,-1
2015,1323,1462,3,6,-3
2015,1326,1462,10,6,4
2015,1328,1462,3,6,-3
2015,1329,1462,9,6,3
2015,1332,1462,8,6,2
2015,1344,1462,6,6,0
2015,1345,1462,9,6,3
2015,1352,1462,16,6,10
2015,1361,1462,8,6,2
2015,1372,1462,12,6,6
2015,1374,1462,6,6,0
2015,1385,1462,9,6,3
2015,1400,1462,11,6,5
2015,1411,1462,15,6,9
2015,1412,1462,14,6,8
2015,1414,1462,13,6,7
2015,1417,1462,11,6,5
2015,1428,1462,5,6,-1
2015,1433,1462,7,6,1
2015,1434,1462,13,6,7
2015,1437,1462,1,6,-5
2015,1438,1462,2,6,-4
2015,1452,1462,5,6,-1
2015,1455,1462,7,6,1
2015,1458,1462,1,6,-5
2015,1459,1462,12,6,6
2015,1461,1462,12,6,6
2016,1112,1114,6,12,-6
2016,1112,1122,6,16,-10
2016,1114,1122,12,16,-4
2016,1112,1124,6,5,1
2016,1114,1124,12,5,7
2016,1122,1124,16,5,11
2016,1112,1138,6,14,-8
2016,1114,1138,12,14,-2
2016,1122,1138,16,14,2
2016,1124,1138,5,14,-9
2016,1112,1139,6,9,-3
2016,1114,1139,12,9,3
2016,1122,1139,16,9,7
2016,1124,1139,5,9,-4
2016,1138,1139,14,9,5
2016,1112,1143,6,4,2
2016,1114,1143,12,4,8
2016,1122,1143,16,4,12
2016,1124,1143,5,4,1
2016,1138,1143,14,4,10
2016,1139,1143,9,4,5
2016,1112,1151,6,12,-6
2016,1114,1151,12,12,0
2016,1122,1151,16,12,4
2016,1124,1151,5,12,-7
2016,1138,1151,14,12,2
2016,1139,1151,9,12,-3
2016,1143,1151,4,12,-8
2016,1112,1153,6,9,-3
2016,1114,1153,12,9,3
2016,1122,1153,16,9,7
2016,1124,1153,5,9,-4
2016,1138,1153,14,9,5
2016,1139,1153,9,9,0
2016,1143,1153,4,9,-5
2016,1151,1153,12,9,3
2016,1112,1160,6,8,-2
2016,1114,1160,12,8,4
2016,1122,1160,16,8,8
2016,1124,1160,5,8,-3
2016,1138,1160,14,8,6
2016,1139,1160,9,8,1
2016,1143,1160,4,8,-4
2016,1151,1160,12,8,4
2016,1153,1160,9,8,1
2016,1112,1163,6,9,-3
2016,1114,1163,12,9,3
2016,1122,1163,16,9,7
2016,1124,1163,5,9,-4
2016,1138,1163,14,9,5
2016,1139,1163,9,9,0
2016,1143,1163,4,9,-5
2016,1151,1163,12,9,3
2016,1153,1163,9,9,0
2016,1160,1163,8,9,-1
2016,1112,1167,6,15,-9
2016,1114,1167,12,15,-3
2016,1122,1167,16,15,1
2016,1124,1167,5,15,-10
2016,1138,1167,14,15,-1
2016,1139,1167,9,15,-6
2016,1143,1167,4,15,-11
2016,1151,1167,12,15,-3
2016,1153,1167,9,15,-6
2016,1160,1167,8,15,-7
2016,1163,1167,9,15,-6
2016,1112,1173,6,7,-1
2016,1114,1173,12,7,5
2016,1122,1173,16,7,9
2016,1124,1173,5,7,-2
2016,1138,1173,14,7,7
2016,1139,1173,9,7,2
2016,1143,1173,4,7,-3
2016,1151,1173,12,7,5
2016,1153,1173,9,7,2
2016,1160,1173,8,7,1
2016,1163,1173,9,7,2
2016,1167,1173,15,7,8
2016,1112,1181,6,4,2
2016,1114,1181,12,4,8
2016,1122,1181,16,4,12
2016,1124,1181,5,4,1
2016,1138,1181,14,4,10
2016,1139,1181,9,4,5
2016,1143,1181,4,4,0
2016,1151,1181,12,4,8
2016,1153,1181,9,4,5
2016,1160,1181,8,4,4
2016,1163,1181,9,4,5
2016,1167,1181,15,4,11
2016,1173,1181,7,4,3
2016,1112,1192,6,16,-10
2016,1114,1192,12,16,-4
2016,1122,1192,16,16,0
2016,1124,1192,5,16,-11
2016,1138,1192,14,16,-2
2016,1139,1192,9,16,-7
2016,1143,1192,4,16,-12
2016,1151,1192,12,16,-4
2016,1153,1192,9,16,-7
2016,1160,1192,8,16,-8
2016,1163,1192,9,16,-7
2016,1167,1192,15,16,-1
2016,1173,1192,7,16,-9
2016,1181,1192,4,16,-12
2016,1112,1195,6,16,-10
2016,1114,1195,12,16,-4
2016,1122,1195,16,16,0
2016,1124,1195,5,16,-11
2016,1138,1195,14,16,-2
2016,1139,1195,9,16,-7
2016,1143,1195,4,16,-12
2016,1151,1195,12,16,-4
2016,1153,1195,9,16,-7
2016,1160,1195,8,16,-8
2016,1163,1195,9,16,-7
2016,1167,1195,15,16,-1
2016,1173,1195,7,16,-9
2016,1181,1195,4,16,-12
2016,1192,1195,16,16,0
2016,1112,1201,6,14,-8
2016,1114,1201,12,14,-2
2016,1122,1201,16,14,2
2016,1124,1201,5,14,-9
2016,1138,1201,14,14,0
2016,1139,1201,9,14,-5
2016,1143,1201,4,14,-10
2016,1151,1201,12,14,-2
2016,1153,1201,9,14,-5
2016,1160,1201,8,14,-6
2016,1163,1201,9,14,-5
2016,1167,1201,15,14,1
2016,1173,1201,7,14,-7
2016,1181,1201,4,14,-10
2016,1192,1201,16,14,2
2016,1195,1201,16,14,2
2016,1112,1211,6,11,-5
2016,1114,1211,12,11,1
2016,1122,1211,16,11,5
2016,1124,1211,5,11,-6
2016,1138,1211,14,11,3
2016,1139,1211,9,11,-2
2016,1143,1211,4,11,-7
2016,1151,1211,12,11,1
2016,1153,1211,9,11,-2
2016,1160,1211,8,11,-3
2016,1163,1211,9,11,-2
2016,1167,1211,15,11,4
2016,1173,1211,7,11,-4
2016,1181,1211,4,11,-7
2016,1192,1211,16,11,5
2016,1195,1211,16,11,5
2016,1201,1211,14,11,3
2016,1112,1214,6,16,-10
2016,1114,1214,12,16,-4
2016,1122,1214,16,16,0
2016,1124,1214,5,16,-11
2016,1138,1214,14,16,-2
2016,1139,1214,9,16,-7
2016,1143,1214,4,16,-12
2016,1151,1214,12,16,-4
2016,1153,1214,9,16,-7
2016,1160,1214,8,16,-8
2016,1163,1214,9,16,-7
2016,1167,1214,15,16,-1
2016,1173,1214,7,16,-9
2016,1181,1214,4,16,-12
2016,1192,1214,16,16,0
2016,1195,1214,16,16,0
2016,1201,1214,14,16,-2
2016,1211,1214,11,16,-5
2016,1112,1218,6,13,-7
2016,1114,1218,12,13,-1
2016,1122,1218,16,13,3
2016,1124,1218,5,13,-8
2016,1138,1218,14,13,1
2016,1139,1218,9,13,-4
2016,1143,1218,4,13,-9
2016,1151,1218,12,13,-1
2016,1153,1218,9,13,-4
2016,1160,1218,8,13,-5
2016,1163,1218,9,13,-4
2016,1167,1218,15,13,2
2016,1173,1218,7,13,-6
2016,1181,1218,4,13,-9
2016,1192,1218,16,13,3
2016,1195,1218,16,13,3
2016,1201,1218,14,13,1
2016,1211,1218,11,13,-2
2016,1214,1218,16,13,3
2016,1112,1221,6,16,-10
2016,1114,1221,12,16,-4
2016,1122,1221,16,16,0
2016,1124,1221,5,16,-11
2016,1138,1221,14,16,-2
2016,1139,1221,9,16,-7
2016,1143,1221,4,16,-12
2016,1151,1221,12,16,-4
2016,1153,1221,9,16,-7
2016,1160,1221,8,16,-8
2016,1163,1221,9,16,-7
2016,1167,1221,15,16,-1
2016,1173,1221,7,16,-9
2016,1181,1221,4,16,-12
2016,1192,1221,16,16,0
2016,1195,1221,16,16,0
2016,1201,1221,14,16,-2
2016,1211,1221,11,16,-5
2016,1214,1221,16,16,0
2016,1218,1221,13,16,-3
2016,1112,1231,6,5,1
2016,1114,1231,12,5,7
2016,1122,1231,16,5,11
2016,1124,1231,5,5,0
2016,1138,1231,14,5,9
2016,1139,1231,9,5,4
2016,1143,1231,4,5,-1
2016,1151,1231,12,5,7
2016,1153,1231,9,5,4
2016,1160,1231,8,5,3
2016,1163,1231,9,5,4
2016,1167,1231,15,5,10
2016,1173,1231,7,5,2
2016,1181,1231,4,5,-1
2016,1192,1231,16,5,11
2016,1195,1231,16,5,11
2016,1201,1231,14,5,9
2016,1211,1231,11,5,6
2016,1214,1231,16,5,11
2016,1218,1231,13,5,8
2016,1221,1231,16,5,11
2016,1112,1233,6,13,-7
2016,1114,1233,12,13,-1
2016,1122,1233,16,13,3
2016,1124,1233,5,13,-8
2016,1138,1233,14,13,1
2016,1139,1233,9,13,-4
2016,1143,1233,4,13,-9
2016,1151,1233,12,13,-1
2016,1153,1233,9,13,-4
2016,1160,1233,8,13,-5
2016,1163,1233,9,13,-4
2016,1167,1233,15,13,2
2016,1173,1233,7,13,-6
2016,1181,1233,4,13,-9
2016,1192,1233,16,13,3
2016,1195,1233,16,13,3
2016,1201,1233,14,13,1
2016,1211,1233,11,13,-2
2016,1214,1233,16,13,3
2016,1218,1233,13,13,0
2016,1221,1233,16,13,3
2016,1231,1233,5,13,-8
2016,1112,1234,6,7,-1
2016,1114,1234,12,7,5
2016,1122,1234,16,7,9
2016,1124,1234,5,7,-2
2016,1138,1234,14,7,7
2016,1139,1234,9,7,2
2016,1143,1234,4,7,-3
2016,1151,1234,12,7,5
2016,1153,1234,9,7,2
2016,1160,1234,8,7,1
2016,1163,1234,9,7,2
2016,1167,1234,15,7,8
2016,1173,1234,7,7,0
2016,1181,1234,4,7,-3
2016,1192,1234,16,7,9
2016,1195,1234,16,7,9
2016,1201,1234,14,7,7
2016,1211,1234,11,7,4
2016,1214,1234,16,7,9
2016,1218,1234,13,7,6
2016,1221,1234,16,7,9
2016,1231,1234,5,7,-2
2016,1233,1234,13,7,6
2016,1112,1235,6,4,2
2016,1114,1235,12,4,8
2016,1122,1235,16,4,12
2016,1124,1235,5,4,1
2016,1138,1235,14,4,10
2016,1139,1235,9,4,5
2016,1143,1235,4,4,0
2016,1151,1235,12,4,8
2016,1153,1235,9,4,5
2016,1160,1235,8,4,4
2016,1163,1235,9,4,5
2016,1167,1235,15,4,11
2016,1173,1235,7,4,3
2016,1181,1235,4,4,0
2016,1192,1235,16,4,12
2016,1195,1235,16,4,12
2016,1201,1235,14,4,10
2016,1211,1235,11,4,7
2016,1214,1235,16,4,12
2016,1218,1235,13,4,9
2016,1221,1235,16,4,12
2016,1231,1235,5,4,1
2016,1233,1235,13,4,9
2016,1234,1235,7,4,3
2016,1112,1242,6,1,5
2016,1114,1242,12,1,11
2016,1122,1242,16,1,15
2016,1124,1242,5,1,4
2016,1138,1242,14,1,13
2016,1139,1242,9,1,8
2016,1143,1242,4,1,3
2016,1151,1242,12,1,11
2016,1153,1242,9,1,8
2016,1160,1242,8,1,7
2016,1163,1242,9,1,8
2016,1167,1242,15,1,14
2016,1173,1242,7,1,6
2016,1181,1242,4,1,3
2016,1192,1242,16,1,15
2016,1195,1242,16,1,15
2016,1201,1242,14,1,13
2016,1211,1242,11,1,10
2016,1214,1242,16,1,15
2016,1218,1242,13,1,12
2016,1221,1242,16,1,15
2016,1231,1242,5,1,4
2016,1233,1242,13,1,12
2016,1234,1242,7,1,6
2016,1235,1242,4,1,3
2016,1112,1246,6,4,2
2016,1114,1246,12,4,8
2016,1122,1246,16,4,12
2016,1124,1246,5,4,1
2016,1138,1246,14,4,10
2016,1139,1246,9,4,5
2016,1143,1246,4,4,0
2016,1151,1246,12,4,8
2016,1153,1246,9,4,5
2016,1160,1246,8,4,4
2016,1163,1246,9,4,5
2016,1167,1246,15,4,11
2016,1173,1246,7,4,3
2016,1181,1246,4,4,0
2016,1192,1246,16,4,12
2016,1195,1246,16,4,12
2016,1201,1246,14,4,10
2016,1211,1246,11,4,7
2016,1214,1246,16,4,12
2016,1218,1246,13,4,9
2016,1221,1246,16,4,12
2016,1231,1246,5,4,1
2016,1233,1246,13,4,9
2016,1234,1246,7,4,3
2016,1235,1246,4,4,0
2016,1242,1246,1,4,-3
2016,1112,1268,6,5,1
2016,1114,1268,12,5,7
2016,1122,1268,16,5,11
2016,1124,1268,5,5,0
2016,1138,1268,14,5,9
2016,1139,1268,9,5,4
2016,1143,1268,4,5,-1
2016,1151,1268,12,5,7
2016,1153,1268,9,5,4
2016,1160,1268,8,5,3
2016,1163,1268,9,5,4
2016,1167,1268,15,5,10
2016,1173,1268,7,5,2
2016,1181,1268,4,5,-1
2016,1192,1268,16,5,11
2016,1195,1268,16,5,11
2016,1201,1268,14,5,9
2016,1211,1268,11,5,6
2016,1214,1268,16,5,11
2016,1218,1268,13,5,8
2016,1221,1268,16,5,11
2016,1231,1268,5,5,0
2016,1233,1268,13,5,8
2016,1234,1268,7,5,2
2016,1235,1268,4,5,-1
2016,1242,1268,1,5,-4
2016,1246,1268,4,5,-1
2016,1112,1274,6,3,3
2016,1114,1274,12,3,9
2016,1122,1274,16,3,13
2016,1124,1274,5,3,2
2016,1138,1274,14,3,11
2016,1139,1274,9,3,6
2016,1143,1274,4,3,1
2016,1151,1274,12,3,9
2016,1153,1274,9,3,6
2016,1160,1274,8,3,5
2016,1163,1274,9,3,6
2016,1167,1274,15,3,12
2016,1173,1274,7,3,4
2016,1181,1274,4,3,1
2016,1192,1274,16,3,13
2016,1195,1274,16,3,13
2016,1201,1274,14,3,11
2016,1211,1274,11,3,8
2016,1214,1274,16,3,13
2016,1218,1274,13,3,10
2016,1221,1274,16,3,13
2016,1231,1274,5,3,2
2016,1233,1274,13,3,10
2016,1234,1274,7,3,4
2016,1235,1274,4,3,1
2016,1242,1274,1,3,-2
2016,1246,1274,4,3,1
2016,1268,1274,5,3,2
2016,1112,1276,6,11,-5
2016,1114,1276,12,11,1
2016,1122,1276,16,11,5
2016,1124,1276,5,11,-6
2016,1138,1276,14,11,3
2016,1139,1276,9,11,-2
2016,1143,1276,4,11,-7
2016,1151,1276,12,11,1
2016,1153,1276,9,11,-2
2016,1160,1276,8,11,-3
2016,1163,1276,9,11,-2
2016,1167,1276,15,11,4
2016,1173,1276,7,11,-4
2016,1181,1276,4,11,-7
2016,1192,1276,16,11,5
2016,1195,1276,16,11,5
2016,1201,1276,14,11,3
2016,1211,1276,11,11,0
2016,1214,1276,16,11,5
2016,1218,1276,13,11,2
2016,1221,1276,16,11,5
2016,1231,1276,5,11,-6
2016,1233,1276,13,11,2
2016,1234,1276,7,11,-4
2016,1235,1276,4,11,-7
2016,1242,1276,1,11,-10
2016,1246,1276,4,11,-7
2016,1268,1276,5,11,-6
2016,1274,1276,3,11,-8
2016,1112,1277,6,2,4
2016,1114,1277,12,2,10
2016,1122,1277,16,2,14
2016,1124,1277,5,2,3
2016,1138,1277,14,2,12
2016,1139,1277,9,2,7
2016,1143,1277,4,2,2
2016,1151,1277,12,2,10
2016,1153,1277,9,2,7
2016,1160,1277,8,2,6
2016,1163,1277,9,2,7
2016,1167,1277,15,2,13
2016,1173,1277,7,2,5
2016,1181,1277,4,2,2
2016,1192,1277,16,2,14
2016,1195,1277,16,2,14
2016,1201,1277,14,2,12
2016,1211,1277,11,2,9
2016,1214,1277,16,2,14
2016,1218,1277,13,2,11
2016,1221,1277,16,2,14
2016,1231,1277,5,2,3
2016,1233,1277,13,2,11
2016,1234,1277,7,2,5
2016,1235,1277,4,2,2
2016,1242,1277,1,2,-1
2016,1246,1277,4,2,2
2016,1268,1277,5,2,3
2016,1274,1277,3,2,1
2016,1276,1277,11,2,9
2016,1112,1292,6,15,-9
2016,1114,1292,12,15,-3
2016,1122,1292,16,15,1
2016,1124,1292,5,15,-10
2016,1138,1292,14,15,-1
2016,1139,1292,9,15,-6
2016,1143,1292,4,15,-11
2016,1151,1292,12,15,-3
2016,1153,1292,9,15,-6
2016,1160,1292,8,15,-7
2016,1163,1292,9,15,-6
2016,1167,1292,15,15,0
2016,1173,1292,7,15,-8
2016,1181,1292,4,15,-11
2016,1192,1292,16,15,1
2016,1195,1292,16,15,1
2016,1201,1292,14,15,-1
2016,1211,1292,11,15,-4
2016,1214,1292,16,15,1
2016,1218,1292,13,15,-2
2016,1221,1292,16,15,1
2016,1231,1292,5,15,-10
2016,1233,1292,13,15,-2
2016,1234,1292,7,15,-8
2016,1235,1292,4,15,-11
2016,1242,1292,1,15,-14
2016,1246,1292,4,15,-11
2016,1268,1292,5,15,-10
2016,1274,1292,3,15,-12
2016,1276,1292,11,15,-4
2016,1277,1292,2,15,-13
2016,1112,1314,6,1,5
2016,1114,1314,12,1,11
2016,1122,1314,16,1,15
2016,1124,1314,5,1,4
2016,1138,1314,14,1,13
2016,1139,1314,9,1,8
2016,1143,1314,4,1,3
2016,1151,1314,12,1,11
2016,1153,1314,9,1,8
2016,1160,1314,8,1,7
2016,1163,1314,9,1,8
2016,1167,1314,15,1,14
2016,1173,1314,7,1,6
2016,1181,1314,4,1,3
2016,1192,1314,16,1,15
2016,1195,1314,16,1,15
2016,1201,1314,14,1,13
2016,1211,1314,11,1,10
2016,1214,1314,16,1,15
2016,1218,1314,13,1,12
2016,1221,1314,16,1,15
2016,1231,1314,5,1,4
2016,1233,1314,13,1,12
2016,1234,1314,7,1,6
2016,1235,1314,4,1,3
2016,1242,1314,1,1,0
2016,1246,1314,4,1,3
2016,1268,1314,5,1,4
2016,1274,1314,3,1,2
2016,1276,1314,11,1,10
2016,1277,1314,2,1,1
2016,1292,1314,15,1,14
2016,1112,1320,6,11,-5
2016,1114,1320,12,11,1
2016,1122,1320,16,11,5
2016,1124,1320,5,11,-6
2016,1138,1320,14,11,3
2016,1139,1320,9,11,-2
2016,1143,1320,4,11,-7
2016,1151,1320,12,11,1
2016,1153,1320,9,11,-2
2016,1160,1320,8,11,-3
2016,1163,1320,9,11,-2
2016,1167,1320,15,11,4
2016,1173,1320,7,11,-4
2016,1181,1320,4,11,-7
2016,1192,1320,16,11,5
2016,1195,1320,16,11,5
2016,1201,1320,14,11,3
2016,1211,1320,11,11,0
2016,1214,1320,16,11,5
2016,1218,1320,13,11,2
2016,1221,1320,16,11,5
2016,1231,1320,5,11,-6
2016,1233,1320,13,11,2
2016,1234,1320,7,11,-4
2016,1235,1320,4,11,-7
2016,1242,1320,1,11,-10
2016,1246,1320,4,11,-7
2016,1268,1320,5,11,-6
2016,1274,1320,3,11,-8
2016,1276,1320,11,11,0
2016,1277,1320,2,11,-9
2016,1292,1320,15,11,4
2016,1314,1320,1,11,-10
2016,1112,1323,6,6,0
2016,1114,1323,12,6,6
2016,1122,1323,16,6,10
2016,1124,1323,5,6,-1
2016,1138,1323,14,6,8
2016,1139,1323,9,6,3
2016,1143,1323,4,6,-2
2016,1151,1323,12,6,6
2016,1153,1323,9,6,3
2016,1160,1323,8,6,2
2016,1163,1323,9,6,3
2016,1167,1323,15,6,9
2016,1173,1323,7,6,1
2016,1181,1323,4,6,-2
2016,1192,1323,16,6,10
2016,1195,1323,16,6,10
2016,1201,1323,14,6,8
2016,1211,1323,11,6,5
2016,1214,1323,16,6,10
2016,1218,1323,13,6,7
2016,1221,1323,16,6,10
2016,1231,1323,5,6,-1
2016,1233,1323,13,6,7
2016,1234,1323,7,6,1
2016,1235,1323,4,6,-2
2016,1242,1323,1,6,-5
2016,1246,1323,4,6,-2
2016,1268,1323,5,6,-1
2016,1274,1323,3,6,-3
2016,1276,1323,11,6,5
2016,1277,1323,2,6,-4
2016,1292,1323,15,6,9
2016,1314,1323,1,6,-5
2016,1320,1323,11,6,5
2016,1112,1328,6,2,4
2016,1114,1328,12,2,10
2016,1122,1328,16,2,14
2016,1124,1328,5,2,3
2016,1138,1328,14,2,12
2016,1139,1328,9,2,7
2016,1143,1328,4,2,2
2016,1151,1328,12,2,10
2016,1153,1328,9,2,7
2016,1160,1328,8,2,6
2016,1163,1328,9,2,7
2016,1167,1328,15,2,13
2016,1173,1328,7,2,5
2016,1181,1328,4,2,2
2016,1192,1328,16,2,14
2016,1195,1328,16,2,14
2016,1201,1328,14,2,12
2016,1211,1328,11,2,9
2016,1214,1328,16,2,14
2016,1218,1328,13,2,11
2016,1221,1328,16,2,14
2016,1231,1328,5,2,3
2016,1233,1328,13,2,11
2016,1234,1328,7,2,5
2016,1235,1328,4,2,2
2016,1242,1328,1,2,-1
2016,1246,1328,4,2,2
2016,1268,1328,5,2,3
2016,1274,1328,3,2,1
2016,1276,1328,11,2,9
2016,1277,1328,2,2,0
2016,1292,1328,15,2,13
2016,1314,1328,1,2,-1
2016,1320,1328,11,2,9
2016,1323,1328,6,2,4
2016,1112,1332,6,1,5
2016,1114,1332,12,1,11
2016,1122,1332,16,1,15
2016,1124,1332,5,1,4
2016,1138,1332,14,1,13
2016,1139,1332,9,1,8
2016,1143,1332,4,1,3
2016,1151,1332,12,1,11
2016,1153,1332,9,1,8
2016,1160,1332,8,1,7
2016,1163,1332,9,1,8
2016,1167,1332,15,1,14
2016,1173,1332,7,1,6
2016,1181,1332,4,1,3
2016,1192,1332,16,1,15
2016,1195,1332,16,1,15
2016,1201,1332,14,1,13
2016,1211,1332,11,1,10
2016,1214,1332,16,1,15
2016,1218,1332,13,1,12
2016,1221,1332,16,1,15
2016,1231,1332,5,1,4
2016,1233,1332,13,1,12
2016,1234,1332,7,1,6
2016,1235,1332,4,1,3
2016,1242,1332,1,1,0
2016,1246,1332,4,1,3
2016,1268,1332,5,1,4
2016,1274,1332,3,1,2
2016,1276,1332,11,1,10
2016,1277,1332,2,1,1
2016,1292,1332,15,1,14
2016,1314,1332,1,1,0
2016,1320,1332,11,1,10
2016,1323,1332,6,1,5
2016,1328,1332,2,1,1
2016,1112,1333,6,7,-1
2016,1114,1333,12,7,5
2016,1122,1333,16,7,9
2016,1124,1333,5,7,-2
2016,1138,1333,14,7,7
2016,1139,1333,9,7,2
2016,1143,1333,4,7,-3
2016,1151,1333,12,7,5
2016,1153,1333,9,7,2
2016,1160,1333,8,7,1
2016,1163,1333,9,7,2
2016,1167,1333,15,7,8
2016,1173,1333,7,7,0
2016,1181,1333,4,7,-3
2016,1192,1333,16,7,9
2016,1195,1333,16,7,9
2016,1201,1333,14,7,7
2016,1211,1333,11,7,4
2016,1214,1333,16,7,9
2016,1218,1333,13,7,6
2016,1221,1333,16,7,9
2016,1231,1333,5,7,-2
2016,1233,1333,13,7,6
2016,1234,1333,7,7,0
2016,1235,1333,4,7,-3
2016,1242,1333,1,7,-6
2016,1246,1333,4,7,-3
2016,1268,1333,5,7,-2
2016,1274,1333,3,7,-4
2016,1276,1333,11,7,4
2016,1277,1333,2,7,-5
2016,1292,1333,15,7,8
2016,1314,1333,1,7,-6
2016,1320,1333,11,7,4
2016,1323,1333,6,7,-1
2016,1328,1333,2,7,-5
2016,1332,1333,1,7,-6
2016,1112,1338,6,10,-4
2016,1114,1338,12,10,2
2016,1122,1338,16,10,6
2016,1124,1338,5,10,-5
2016,1138,1338,14,10,4
2016,1139,1338,9,10,-1
2016,1143,1338,4,10,-6
2016,1151,1338,12,10,2
2016,1153,1338,9,10,-1
2016,1160,1338,8,10,-2
2016,1163,1338,9,10,-1
2016,1167,1338,15,10,5
2016,1173,1338,7,10,-3
2016,1181,1338,4,10,-6
2016,1192,1338,16,10,6
2016,1195,1338,16,10,6
2016,1201,1338,14,10,4
2016,1211,1338,11,10,1
2016,1214,1338,16,10,6
2016,1218,1338,13,10,3
2016,1221,1338,16,10,6
2016,1231,1338,5,10,-5
2016,1233,1338,13,10,3
2016,1234,1338,7,10,-3
2016,1235,1338,4,10,-6
2016,1242,1338,1,10,-9
2016,1246,1338,4,10,-6
2016,1268,1338,5,10,-5
2016,1274,1338,3,10,-7
2016,1276,1338,11,10,1
2016,1277,1338,2,10,-8
2016,1292,1338,15,10,5
2016,1314,1338,1,10,-9
2016,1320,1338,11,10,1
2016,1323,1338,6,10,-4
2016,1328,1338,2,10,-8
2016,1332,1338,1,10,-9
2016,1333,1338,7,10,-3
2016,1112,1344,6,9,-3
2016,1114,1344,12,9,3
2016,1122,1344,16,9,7
2016,1124,1344,5,9,-4
2016,1138,1344,14,9,5
2016,1139,1344,9,9,0
2016,1143,1344,4,9,-5
2016,1151,1344,12,9,3
2016,1153,1344,9,9,0
2016,1160,1344,8,9,-1
2016,1163,1344,9,9,0
2016,1167,1344,15,9,6
2016,1173,1344,7,9,-2
2016,1181,1344,4,9,-5
2016,1192,1344,16,9,7
2016,1195,1344,16,9,7
2016,1201,1344,14,9,5
2016,1211,1344,11,9,2
2016,1214,1344,16,9,7
2016,1218,1344,13,9,4
2016,1221,1344,16,9,7
2016,1231,1344,5,9,-4
2016,1233,1344,13,9,4
2016,1234,1344,7,9,-2
2016,1235,1344,4,9,-5
2016,1242,1344,1,9,-8
2016,1246,1344,4,9,-5
2016,1268,1344,5,9,-4
2016,1274,1344,3,9,-6
2016,1276,1344,11,9,2
2016,1277,1344,2,9,-7
2016,1292,1344,15,9,6
2016,1314,1344,1,9,-8
2016,1320,1344,11,9,2
2016,1323,1344,6,9,-3
2016,1328,1344,2,9,-7
2016,1332,1344,1,9,-8
2016,1333,1344,7,9,-2
2016,1338,1344,10,9,1
2016,1112,1345,6,5,1
2016,1114,1345,12,5,7
2016,1122,1345,16,5,11
2016,1124,1345,5,5,0
2016,1138,1345,14,5,9
2016,1139,1345,9,5,4
2016,1143,1345,4,5,-1
2016,1151,1345,12,5,7
2016,1153,1345,9,5,4
2016,1160,1345,8,5,3
2016,1163,1345,9,5,4
2016,1167,1345,15,5,10
2016,1173,1345,7,5,2
2016,1181,1345,4,5,-1
2016,1192,1345,16,5,11
2016,1195,1345,16,5,11
2016,1201,1345,14,5,9
2016,1211,1345,11,5,6
2016,1214,1345,16,5,11
2016,1218,1345,13,5,8
2016,1221,1345,16,5,11
2016,1231,1345,5,5,0
2016,1233,1345,13,5,8
2016,1234,1345,7,5,2
2016,1235,1345,4,5,-1
2016,1242,1345,1,5,-4
2016,1246,1345,4,5,-1
2016,1268,1345,5,5,0
2016,1274,1345,3,5,-2
2016,1276,1345,11,5,6
2016,1277,1345,2,5,-3
2016,1292,1345,15,5,10
2016,1314,1345,1,5,-4
2016,1320,1345,11,5,6
2016,1323,1345,6,5,1
2016,1328,1345,2,5,-3
2016,1332,1345,1,5,-4
2016,1333,1345,7,5,2
2016,1338,1345,10,5,5
2016,1344,1345,9,5,4
2016,1112,1355,6,12,-6
2016,1114,1355,12,12,0
2016,1122,1355,16,12,4
2016,1124,1355,5,12,-7
2016,1138,1355,14,12,2
2016,1139,1355,9,12,-3
2016,1143,1355,4,12,-8
2016,1151,1355,12,12,0
2016,1153,1355,9,12,-3
2016,1160,1355,8,12,-4
2016,1163,1355,9,12,-3
2016,1167,1355,15,12,3
2016,1173,1355,7,12,-5
2016,1181,1355,4,12,-8
2016,1192,1355,16,12,4
2016,1195,1355,16,12,4
2016,1201,1355,14,12,2
2016,1211,1355,11,12,-1
2016,1214,1355,16,12,4
2016,1218,1355,13,12,1
2016,1221,1355,16,12,4
2016,1231,1355,5,12,-7
2016,1233,1355,13,12,1
2016,1234,1355,7,12,-5
2016,1235,1355,4,12,-8
2016,1242,1355,1,12,-11
2016,1246,1355,4,12,-8
2016,1268,1355,5,12,-7
2016,1274,1355,3,12,-9
2016,1276,1355,11,12,-1
2016,1277,1355,2,12,-10
2016,1292,1355,15,12,3
2016,1314,1355,1,12,-11
2016,1320,1355,11,12,-1
2016,1323,1355,6,12,-6
2016,1328,1355,2,12,-10
2016,1332,1355,1,12,-11
2016,1333,1355,7,12,-5
2016,1338,1355,10,12,-2
2016,1344,1355,9,12,-3
2016,1345,1355,5,12,-7
2016,1112,1371,6,6,0
2016,1114,1371,12,6,6
2016,1122,1371,16,6,10
2016,1124,1371,5,6,-1
2016,1138,1371,14,6,8
2016,1139,1371,9,6,3
2016,1143,1371,4,6,-2
2016,1151,1371,12,6,6
2016,1153,1371,9,6,3
2016,1160,1371,8,6,2
2016,1163,1371,9,6,3
2016,1167,1371,15,6,9
2016,1173,1371,7,6,1
2016,1181,1371,4,6,-2
2016,1192,1371,16,6,10
2016,1195,1371,16,6,10
2016,1201,1371,14,6,8
2016,1211,1371,11,6,5
2016,1214,1371,16,6,10
2016,1218,1371,13,6,7
2016,1221,1371,16,6,10
2016,1231,1371,5,6,-1
2016,1233,1371,13,6,7
2016,1234,1371,7,6,1
2016,1235,1371,4,6,-2
2016,1242,1371,1,6,-5
2016,1246,1371,4,6,-2
2016,1268,1371,5,6,-1
2016,1274,1371,3,6,-3
2016,1276,1371,11,6,5
2016,1277,1371,2,6,-4
2016,1292,1371,15,6,9
2016,1314,1371,1,6,-5
2016,1320,1371,11,6,5
2016,1323,1371,6,6,0
2016,1328,1371,2,6,-4
2016,1332,1371,1,6,-5
2016,1333,1371,7,6,1
2016,1338,1371,10,6,4
2016,1344,1371,9,6,3
2016,1345,1371,5,6,-1
2016,1355,1371,12,6,6
2016,1112,1372,6,14,-8
2016,1114,1372,12,14,-2
2016,1122,1372,16,14,2
2016,1124,1372,5,14,-9
2016,1138,1372,14,14,0
2016,1139,1372,9,14,-5
2016,1143,1372,4,14,-10
2016,1151,1372,12,14,-2
2016,1153,1372,9,14,-5
2016,1160,1372,8,14,-6
2016,1163,1372,9,14,-5
2016,1167,1372,15,14,1
2016,1173,1372,7,14,-7
2016,1181,1372,4,14,-10
2016,1192,1372,16,14,2
2016,1195,1372,16,14,2
2016,1201,1372,14,14,0
2016,1211,1372,11,14,-3
2016,1214,1372,16,14,2
2016,1218,1372,13,14,-1
2016,1221,1372,16,14,2
2016,1231,1372,5,14,-9
2016,1233,1372,13,14,-1
2016,1234,1372,7,14,-7
2016,1235,1372,4,14,-10
2016,1242,1372,1,14,-13
2016,1246,1372,4,14,-10
2016,1268,1372,5,14,-9
2016,1274,1372,3,14,-11
2016,1276,1372,11,14,-3
2016,1277,1372,2,14,-12
2016,1292,1372,15,14,1
2016,1314,1372,1,14,-13
2016,1320,1372,11,14,-3
2016,1323,1372,6,14,-8
2016,1328,1372,2,14,-12
2016,1332,1372,1,14,-13
2016,1333,1372,7,14,-7
2016,1338,1372,10,14,-4
2016,1344,1372,9,14,-5
2016,1345,1372,5,14,-9
2016,1355,1372,12,14,-2
2016,1371,1372,6,14,-8
2016,1112,1380,6,16,-10
2016,1114,1380,12,16,-4
2016,1122,1380,16,16,0
2016,1124,1380,5,16,-11
2016,1138,1380,14,16,-2
2016,1139,1380,9,16,-7
2016,1143,1380,4,16,-12
2016,1151,1380,12,16,-4
2016,1153,1380,9,16,-7
2016,1160,1380,8,16,-8
2016,1163,1380,9,16,-7
2016,1167,1380,15,16,-1
2016,1173,1380,7,16,-9
2016,1181,1380,4,16,-12
2016,1192,1380,16,16,0
2016,1195,1380,16,16,0
2016,1201,1380,14,16,-2
2016,1211,1380,11,16,-5
2016,1214,1380,16,16,0
2016,1218,1380,13,16,-3
2016,1221,1380,16,16,0
2016,1231,1380,5,16,-11
2016,1233,1380,13,16,-3
2016,1234,1380,7,16,-9
2016,1235,1380,4,16,-12
2016,1242,1380,1,16,-15
2016,1246,1380,4,16,-12
2016,1268,1380,5,16,-11
2016,1274,1380,3,16,-13
2016,1276,1380,11,16,-5
2016,1277,1380,2,16,-14
2016,1292,1380,15,16,-1
2016,1314,1380,1,16,-15
2016,1320,1380,11,16,-5
2016,1323,1380,6,16,-10
2016,1328,1380,2,16,-14
2016,1332,1380,1,16,-15
2016,1333,1380,7,16,-9
2016,1338,1380,10,16,-6
2016,1344,1380,9,16,-7
2016,1345,1380,5,16,-11
2016,1355,1380,12,16,-4
2016,1371,1380,6,16,-10
2016,1372,1380,14,16,-2
2016,1112,1386,6,8,-2
2016,1114,1386,12,8,4
2016,1122,1386,16,8,8
2016,1124,1386,5,8,-3
2016,1138,1386,14,8,6
2016,1139,1386,9,8,1
2016,1143,1386,4,8,-4
2016,1151,1386,12,8,4
2016,1153,1386,9,8,1
2016,1160,1386,8,8,0
2016,1163,1386,9,8,1
2016,1167,1386,15,8,7
2016,1173,1386,7,8,-1
2016,1181,1386,4,8,-4
2016,1192,1386,16,8,8
2016,1195,1386,16,8,8
2016,1201,1386,14,8,6
2016,1211,1386,11,8,3
2016,1214,1386,16,8,8
2016,1218,1386,13,8,5
2016,1221,1386,16,8,8
2016,1231,1386,5,8,-3
2016,1233,1386,13,8,5
2016,1234,1386,7,8,-1
2016,1235,1386,4,8,-4
2016,1242,1386,1,8,-7
2016,1246,1386,4,8,-4
2016,1268,1386,5,8,-3
2016,1274,1386,3,8,-5
2016,1276,1386,11,8,3
2016,1277,1386,2,8,-6
2016,1292,1386,15,8,7
2016,1314,1386,1,8,-7
2016,1320,1386,11,8,3
2016,1323,1386,6,8,-2
2016,1328,1386,2,8,-6
2016,1332,1386,1,8,-7
2016,1333,1386,7,8,-1
2016,1338,1386,10,8,2
2016,1344,1386,9,8,1
2016,1345,1386,5,8,-3
2016,1355,1386,12,8,4
2016,1371,1386,6,8,-2
2016,1372,1386,14,8,6
2016,1380,1386,16,8,8
2016,1112,1392,6,13,-7
2016,1114,1392,12,13,-1
2016,1122,1392,16,13,3
2016,1124,1392,5,13,-8
2016,1138,1392,14,13,1
2016,1139,1392,9,13,-4
2016,1143,1392,4,13,-9
2016,1151,1392,12,13,-1
2016,1153,1392,9,13,-4
2016,1160,1392,8,13,-5
2016,1163,1392,9,13,-4
2016,1167,1392,15,13,2
2016,1173,1392,7,13,-6
2016,1181,1392,4,13,-9
2016,1192,1392,16,13,3
2016,1195,1392,16,13,3
2016,1201,1392,14,13,1
2016,1211,1392,11,13,-2
2016,1214,1392,16,13,3
2016,1218,1392,13,13,0
2016,1221,1392,16,13,3
2016,1231,1392,5,13,-8
2016,1233,1392,13,13,0
2016,1234,1392,7,13,-6
2016,1235,1392,4,13,-9
2016,1242,1392,1,13,-12
2016,1246,1392,4,13,-9
2016,1268,1392,5,13,-8
2016,1274,1392,3,13,-10
2016,1276,1392,11,13,-2
2016,1277,1392,2,13,-11
2016,1292,1392,15,13,2
2016,1314,1392,1,13,-12
2016,1320,1392,11,13,-2
2016,1323,1392,6,13,-7
2016,1328,1392,2,13,-11
2016,1332,1392,1,13,-12
2016,1333,1392,7,13,-6
2016,1338,1392,10,13,-3
2016,1344,1392,9,13,-4
2016,1345,1392,5,13,-8
2016,1355,1392,12,13,-1
2016,1371,1392,6,13,-7
2016,1372,1392,14,13,1
2016,1380,1392,16,13,3
2016,1386,1392,8,13,-5
2016,1112,1393,6,10,-4
2016,1114,1393,12,10,2
2016,1122,1393,16,10,6
2016,1124,1393,5,10,-5
2016,1138,1393,14,10,4
2016,1139,1393,9,10,-1
2016,1143,1393,4,10,-6
2016,1151,1393,12,10,2
2016,1153,1393,9,10,-1
2016,1160,1393,8,10,-2
2016,1163,1393,9,10,-1
2016,1167,1393,15,10,5
2016,1173,1393,7,10,-3
2016,1181,1393,4,10,-6
2016,1192,1393,16,10,6
2016,1195,1393,16,10,6
2016,1201,1393,14,10,4
2016,1211,1393,11,10,1
2016,1214,1393,16,10,6
2016,1218,1393,13,10,3
2016,1221,1393,16,10,6
2016,1231,1393,5,10,-5
2016,1233,1393,13,10,3
2016,1234,1393,7,10,-3
2016,1235,1393,4,10,-6
2016,1242,1393,1,10,-9
2016,1246,1393,4,10,-6
2016,1268,1393,5,10,-5
2016,1274,1393,3,10,-7
2016,1276,1393,11,10,1
2016,1277,1393,2,10,-8
2016,1292,1393,15,10,5
2016,1314,1393,1,10,-9
2016,1320,1393,11,10,1
2016,1323,1393,6,10,-4
2016,1328,1393,2,10,-8
2016,1332,1393,1,10,-9
2016,1333,1393,7,10,-3
2016,1338,1393,10,10,0
2016,1344,1393,9,10,-1
2016,1345,1393,5,10,-5
2016,1355,1393,12,10,2
2016,1371,1393,6,10,-4
2016,1372,1393,14,10,4
2016,1380,1393,16,10,6
2016,1386,1393,8,10,-2
2016,1392,1393,13,10,3
2016,1112,1396,6,10,-4
2016,1114,1396,12,10,2
2016,1122,1396,16,10,6
2016,1124,1396,5,10,-5
2016,1138,1396,14,10,4
2016,1139,1396,9,10,-1
2016,1143,1396,4,10,-6
2016,1151,1396,12,10,2
2016,1153,1396,9,10,-1
2016,1160,1396,8,10,-2
2016,1163,1396,9,10,-1
2016,1167,1396,15,10,5
2016,1173,1396,7,10,-3
2016,1181,1396,4,10,-6
2016,1192,1396,16,10,6
2016,1195,1396,16,10,6
2016,1201,1396,14,10,4
2016,1211,1396,11,10,1
2016,1214,1396,16,10,6
2016,1218,1396,13,10,3
2016,1221,1396,16,10,6
2016,1231,1396,5,10,-5
2016,1233,1396,13,10,3
2016,1234,1396,7,10,-3
2016,1235,1396,4,10,-6
2016,1242,1396,1,10,-9
2016,1246,1396,4,10,-6
2016,1268,1396,5,10,-5
2016,1274,1396,3,10,-7
2016,1276,1396,11,10,1
2016,1277,1396,2,10,-8
2016,1292,1396,15,10,5
2016,1314,1396,1,10,-9
2016,1320,1396,11,10,1
2016,1323,1396,6,10,-4
2016,1328,1396,2,10,-8
2016,1332,1396,1,10,-9
2016,1333,1396,7,10,-3
2016,1338,1396,10,10,0
2016,1344,1396,9,10,-1
2016,1345,1396,5,10,-5
2016,1355,1396,12,10,2
2016,1371,1396,6,10,-4
2016,1372,1396,14,10,4
2016,1380,1396,16,10,6
2016,1386,1396,8,10,-2
2016,1392,1396,13,10,3
2016,1393,1396,10,10,0
2016,1112,1400,6,6,0
2016,1114,1400,12,6,6
2016,1122,1400,16,6,10
2016,1124,1400,5,6,-1
2016,1138,1400,14,6,8
2016,1139,1400,9,6,3
2016,1143,1400,4,6,-2
2016,1151,1400,12,6,6
2016,1153,1400,9,6,3
2016,1160,1400,8,6,2
2016,1163,1400,9,6,3
2016,1167,1400,15,6,9
2016,1173,1400,7,6,1
2016,1181,1400,4,6,-2
2016,1192,1400,16,6,10
2016,1195,1400,16,6,10
2016,1201,1400,14,6,8
2016,1211,1400,11,6,5
2016,1214,1400,16,6,10
2016,1218,1400,13,6,7
2016,1221,1400,16,6,10
2016,1231,1400,5,6,-1
2016,1233,1400,13,6,7
2016,1234,1400,7,6,1
2016,1235,1400,4,6,-2
2016,1242,1400,1,6,-5
2016,1246,1400,4,6,-2
2016,1268,1400,5,6,-1
2016,1274,1400,3,6,-3
2016,1276,1400,11,6,5
2016,1277,1400,2,6,-4
2016,1292,1400,15,6,9
2016,1314,1400,1,6,-5
2016,1320,1400,11,6,5
2016,1323,1400,6,6,0
2016,1328,1400,2,6,-4
2016,1332,1400,1,6,-5
2016,1333,1400,7,6,1
2016,1338,1400,10,6,4
2016,1344,1400,9,6,3
2016,1345,1400,5,6,-1
2016,1355,1400,12,6,6
2016,1371,1400,6,6,0
2016,1372,1400,14,6,8
2016,1380,1400,16,6,10
2016,1386,1400,8,6,2
2016,1392,1400,13,6,7
2016,1393,1400,10,6,4
2016,1396,1400,10,6,4
2016,1112,1401,6,3,3
2016,1114,1401,12,3,9
2016,1122,1401,16,3,13
2016,1124,1401,5,3,2
2016,1138,1401,14,3,11
2016,1139,1401,9,3,6
2016,1143,1401,4,3,1
2016,1151,1401,12,3,9
2016,1153,1401,9,3,6
2016,1160,1401,8,3,5
2016,1163,1401,9,3,6
2016,1167,1401,15,3,12
2016,1173,1401,7,3,4
2016,1181,1401,4,3,1
2016,1192,1401,16,3,13
2016,1195,1401,16,3,13
2016,1201,1401,14,3,11
2016,1211,1401,11,3,8
2016,1214,1401,16,3,13
2016,1218,1401,13,3,10
2016,1221,1401,16,3,13
2016,1231,1401,5,3,2
2016,1233,1401,13,3,10
2016,1234,1401,7,3,4
2016,1235,1401,4,3,1
2016,1242,1401,1,3,-2
2016,1246,1401,4,3,1
2016,1268,1401,5,3,2
2016,1274,1401,3,3,0
2016,1276,1401,11,3,8
2016,1277,1401,2,3,-1
2016,1292,1401,15,3,12
2016,1314,1401,1,3,-2
2016,1320,1401,11,3,8
2016,1323,1401,6,3,3
2016,1328,1401,2,3,-1
2016,1332,1401,1,3,-2
2016,1333,1401,7,3,4
2016,1338,1401,10,3,7
2016,1344,1401,9,3,6
2016,1345,1401,5,3,2
2016,1355,1401,12,3,9
2016,1371,1401,6,3,3
2016,1372,1401,14,3,11
2016,1380,1401,16,3,13
2016,1386,1401,8,3,5
2016,1392,1401,13,3,10
2016,1393,1401,10,3,7
2016,1396,1401,10,3,7
2016,1400,1401,6,3,3
2016,1112,1403,6,8,-2
2016,1114,1403,12,8,4
2016,1122,1403,16,8,8
2016,1124,1403,5,8,-3
2016,1138,1403,14,8,6
2016,1139,1403,9,8,1
2016,1143,1403,4,8,-4
2016,1151,1403,12,8,4
2016,1153,1403,9,8,1
2016,1160,1403,8,8,0
2016,1163,1403,9,8,1
2016,1167,1403,15,8,7
2016,1173,1403,7,8,-1
2016,1181,1403,4,8,-4
2016,1192,1403,16,8,8
2016,1195,1403,16,8,8
2016,1201,1403,14,8,6
2016,1211,1403,11,8,3
2016,1214,1403,16,8,8
2016,1218,1403,13,8,5
2016,1221,1403,16,8,8
2016,1231,1403,5,8,-3
2016,1233,1403,13,8,5
2016,1234,1403,7,8,-1
2016,1235,1403,4,8,-4
2016,1242,1403,1,8,-7
2016,1246,1403,4,8,-4
2016,1268,1403,5,8,-3
2016,1274,1403,3,8,-5
2016,1276,1403,11,8,3
2016,1277,1403,2,8,-6
2016,1292,1403,15,8,7
2016,1314,1403,1,8,-7
2016,1320,1403,11,8,3
2016,1323,1403,6,8,-2
2016,1328,1403,2,8,-6
2016,1332,1403,1,8,-7
2016,1333,1403,7,8,-1
2016,1338,1403,10,8,2
2016,1344,1403,9,8,1
2016,1345,1403,5,8,-3
2016,1355,1403,12,8,4
2016,1371,1403,6,8,-2
2016,1372,1403,14,8,6
2016,1380,1403,16,8,8
2016,1386,1403,8,8,0
2016,1392,1403,13,8,5
2016,1393,1403,10,8,2
2016,1396,1403,10,8,2
2016,1400,1403,6,8,-2
2016,1401,1403,3,8,-5
2016,1112,1409,6,11,-5
2016,1114,1409,12,11,1
2016,1122,1409,16,11,5
2016,1124,1409,5,11,-6
2016,1138,1409,14,11,3
2016,1139,1409,9,11,-2
2016,1143,1409,4,11,-7
2016,1151,1409,12,11,1
2016,1153,1409,9,11,-2
2016,1160,1409,8,11,-3
2016,1163,1409,9,11,-2
2016,1167,1409,15,11,4
2016,1173,1409,7,11,-4
2016,1181,1409,4,11,-7
2016,1192,1409,16,11,5
2016,1195,1409,16,11,5
2016,1201,1409,14,11,3
2016,1211,1409,11,11,0
2016,1214,1409,16,11,5
2016,1218,1409,13,11,2
2016,1221,1409,16,11,5
2016,1231,1409,5,11,-6
2016,1233,1409,13,11,2
2016,1234,1409,7,11,-4
2016,1235,1409,4,11,-7
2016,1242,1409,1,11,-10
2016,1246,1409,4,11,-7
2016,1268,1409,5,11,-6
2016,1274,1409,3,11,-8
2016,1276,1409,11,11,0
2016,1277,1409,2,11,-9
2016,1292,1409,15,11,4
2016,1314,1409,1,11,-10
2016,1320,1409,11,11,0
2016,1323,1409,6,11,-5
2016,1328,1409,2,11,-9
2016,1332,1409,1,11,-10
2016,1333,1409,7,11,-4
2016,1338,1409,10,11,-1
2016,1344,1409,9,11,-2
2016,1345,1409,5,11,-6
2016,1355,1409,12,11,1
2016,1371,1409,6,11,-5
2016,1372,1409,14,11,3
2016,1380,1409,16,11,5
2016,1386,1409,8,11,-3
2016,1392,1409,13,11,2
2016,1393,1409,10,11,-1
2016,1396,1409,10,11,-1
2016,1400,1409,6,11,-5
2016,1401,1409,3,11,-8
2016,1403,1409,8,11,-3
2016,1112,1421,6,15,-9
2016,1114,1421,12,15,-3
2016,1122,1421,16,15,1
2016,1124,1421,5,15,-10
2016,1138,1421,14,15,-1
2016,1139,1421,9,15,-6
2016,1143,1421,4,15,-11
2016,1151,1421,12,15,-3
2016,1153,1421,9,15,-6
2016,1160,1421,8,15,-7
2016,1163,1421,9,15,-6
2016,1167,1421,15,15,0
2016,1173,1421,7,15,-8
2016,1181,1421,4,15,-11
2016,1192,1421,16,15,1
2016,1195,1421,16,15,1
2016,1201,1421,14,15,-1
2016,1211,1421,11,15,-4
2016,1214,1421,16,15,1
2016,1218,1421,13,15,-2
2016,1221,1421,16,15,1
2016,1231,1421,5,15,-10
2016,1233,1421,13,15,-2
2016,1234,1421,7,15,-8
2016,1235,1421,4,15,-11
2016,1242,1421,1,15,-14
2016,1246,1421,4,15,-11
2016,1268,1421,5,15,-10
2016,1274,1421,3,15,-12
2016,1276,1421,11,15,-4
2016,1277,1421,2,15,-13
2016,1292,1421,15,15,0
2016,1314,1421,1,15,-14
2016,1320,1421,11,15,-4
2016,1323,1421,6,15,-9
2016,1328,1421,2,15,-13
2016,1332,1421,1,15,-14
2016,1333,1421,7,15,-8
2016,1338,1421,10,15,-5
2016,1344,1421,9,15,-6
2016,1345,1421,5,15,-10
2016,1355,1421,12,15,-3
2016,1371,1421,6,15,-9
2016,1372,1421,14,15,-1
2016,1380,1421,16,15,1
2016,1386,1421,8,15,-7
2016,1392,1421,13,15,-2
2016,1393,1421,10,15,-5
2016,1396,1421,10,15,-5
2016,1400,1421,6,15,-9
2016,1401,1421,3,15,-12
2016,1403,1421,8,15,-7
2016,1409,1421,11,15,-4
2016,1112,1423,6,13,-7
2016,1114,1423,12,13,-1
2016,1122,1423,16,13,3
2016,1124,1423,5,13,-8
2016,1138,1423,14,13,1
2016,1139,1423,9,13,-4
2016,1143,1423,4,13,-9
2016,1151,1423,12,13,-1
2016,1153,1423,9,13,-4
2016,1160,1423,8,13,-5
2016,1163,1423,9,13,-4
2016,1167,1423,15,13,2
2016,1173,1423,7,13,-6
2016,1181,1423,4,13,-9
2016,1192,1423,16,13,3
2016,1195,1423,16,13,3
2016,1201,1423,14,13,1
2016,1211,1423,11,13,-2
2016,1214,1423,16,13,3
2016,1218,1423,13,13,0
2016,1221,1423,16,13,3
2016,1231,1423,5,13,-8
2016,1233,1423,13,13,0
2016,1234,1423,7,13,-6
2016,1235,1423,4,13,-9
2016,1242,1423,1,13,-12
2016,1246,1423,4,13,-9
2016,1268,1423,5,13,-8
2016,1274,1423,3,13,-10
2016,1276,1423,11,13,-2
2016,1277,1423,2,13,-11
2016,1292,1423,15,13,2
2016,1314,1423,1,13,-12
2016,1320,1423,11,13,-2
2016,1323,1423,6,13,-7
2016,1328,1423,2,13,-11
2016,1332,1423,1,13,-12
2016,1333,1423,7,13,-6
2016,1338,1423,10,13,-3
2016,1344,1423,9,13,-4
2016,1345,1423,5,13,-8
2016,1355,1423,12,13,-1
2016,1371,1423,6,13,-7
2016,1372,1423,14,13,1
2016,1380,1423,16,13,3
2016,1386,1423,8,13,-5
2016,1392,1423,13,13,0
2016,1393,1423,10,13,-3
2016,1396,1423,10,13,-3
2016,1400,1423,6,13,-7
2016,1401,1423,3,13,-10
2016,1403,1423,8,13,-5
2016,1409,1423,11,13,-2
2016,1421,1423,15,13,2
2016,1112,1425,6,8,-2
2016,1114,1425,12,8,4
2016,1122,1425,16,8,8
2016,1124,1425,5,8,-3
2016,1138,1425,14,8,6
2016,1139,1425,9,8,1
2016,1143,1425,4,8,-4
2016,1151,1425,12,8,4
2016,1153,1425,9,8,1
2016,1160,1425,8,8,0
2016,1163,1425,9,8,1
2016,1167,1425,15,8,7
2016,1173,1425,7,8,-1
2016,1181,1425,4,8,-4
2016,1192,1425,16,8,8
2016,1195,1425,16,8,8
2016,1201,1425,14,8,6
2016,1211,1425,11,8,3
2016,1214,1425,16,8,8
2016,1218,1425,13,8,5
2016,1221,1425,16,8,8
2016,1231,1425,5,8,-3
2016,1233,1425,13,8,5
2016,1234,1425,7,8,-1
2016,1235,1425,4,8,-4
2016,1242,1425,1,8,-7
2016,1246,1425,4,8,-4
2016,1268,1425,5,8,-3
2016,1274,1425,3,8,-5
2016,1276,1425,11,8,3
2016,1277,1425,2,8,-6
2016,1292,1425,15,8,7
2016,1314,1425,1,8,-7
2016,1320,1425,11,8,3
2016,1323,1425,6,8,-2
2016,1328,1425,2,8,-6
2016,1332,1425,1,8,-7
2016,1333,1425,7,8,-1
2016,1338,1425,10,8,2
2016,1344,1425,9,8,1
2016,1345,1425,5,8,-3
2016,1355,1425,12,8,4
2016,1371,1425,6,8,-2
2016,1372,1425,14,8,6
2016,1380,1425,16,8,8
2016,1386,1425,8,8,0
2016,1392,1425,13,8,5
2016,1393,1425,10,8,2
2016,1396,1425,10,8,2
2016,1400,1425,6,8,-2
2016,1401,1425,3,8,-5
2016,1403,1425,8,8,0
2016,1409,1425,11,8,3
2016,1421,1425,15,8,7
2016,1423,1425,13,8,5
2016,1112,1428,6,3,3
2016,1114,1428,12,3,9
2016,1122,1428,16,3,13
2016,1124,1428,5,3,2
2016,1138,1428,14,3,11
2016,1139,1428,9,3,6
2016,1143,1428,4,3,1
2016,1151,1428,12,3,9
2016,1153,1428,9,3,6
2016,1160,1428,8,3,5
2016,1163,1428,9,3,6
2016,1167,1428,15,3,12
2016,1173,1428,7,3,4
2016,1181,1428,4,3,1
2016,1192,1428,16,3,13
2016,1195,1428,16,3,13
2016,1201,1428,14,3,11
2016,1211,1428,11,3,8
2016,1214,1428,16,3,13
2016,1218,1428,13,3,10
2016,1221,1428,16,3,13
2016,1231,1428,5,3,2
2016,1233,1428,13,3,10
2016,1234,1428,7,3,4
2016,1235,1428,4,3,1
2016,1242,1428,1,3,-2
2016,1246,1428,4,3,1
2016,1268,1428,5,3,2
2016,1274,1428,3,3,0
2016,1276,1428,11,3,8
2016,1277,1428,2,3,-1
2016,1292,1428,15,3,12
2016,1314,1428,1,3,-2
2016,1320,1428,11,3,8
2016,1323,1428,6,3,3
2016,1328,1428,2,3,-1
2016,1332,1428,1,3,-2
2016,1333,1428,7,3,4
2016,1338,1428,10,3,7
2016,1344,1428,9,3,6
2016,1345,1428,5,3,2
2016,1355,1428,12,3,9
2016,1371,1428,6,3,3
2016,1372,1428,14,3,11
2016,1380,1428,16,3,13
2016,1386,1428,8,3,5
2016,1392,1428,13,3,10
2016,1393,1428,10,3,7
2016,1396,1428,10,3,7
2016,1400,1428,6,3,3
2016,1401,1428,3,3,0
2016,1403,1428,8,3,5
2016,1409,1428,11,3,8
2016,1421,1428,15,3,12
2016,1423,1428,13,3,10
2016,1425,1428,8,3,5
2016,1112,1433,6,10,-4
2016,1114,1433,12,10,2
2016,1122,1433,16,10,6
2016,1124,1433,5,10,-5
2016,1138,1433,14,10,4
2016,1139,1433,9,10,-1
2016,1143,1433,4,10,-6
2016,1151,1433,12,10,2
2016,1153,1433,9,10,-1
2016,1160,1433,8,10,-2
2016,1163,1433,9,10,-1
2016,1167,1433,15,10,5
2016,1173,1433,7,10,-3
2016,1181,1433,4,10,-6
2016,1192,1433,16,10,6
2016,1195,1433,16,10,6
2016,1201,1433,14,10,4
2016,1211,1433,11,10,1
2016,1214,1433,16,10,6
2016,1218,1433,13,10,3
2016,1221,1433,16,10,6
2016,1231,1433,5,10,-5
2016,1233,1433,13,10,3
2016,1234,1433,7,10,-3
2016,1235,1433,4,10,-6
2016,1242,1433,1,10,-9
2016,1246,1433,4,10,-6
2016,1268,1433,5,10,-5
2016,1274,1433,3,10,-7
2016,1276,1433,11,10,1
2016,1277,1433,2,10,-8
2016,1292,1433,15,10,5
2016,1314,1433,1,10,-9
2016,1320,1433,11,10,1
2016,1323,1433,6,10,-4
2016,1328,1433,2,10,-8
2016,1332,1433,1,10,-9
2016,1333,1433,7,10,-3
2016,1338,1433,10,10,0
2016,1344,1433,9,10,-1
2016,1345,1433,5,10,-5
2016,1355,1433,12,10,2
2016,1371,1433,6,10,-4
2016,1372,1433,14,10,4
2016,1380,1433,16,10,6
2016,1386,1433,8,10,-2
2016,1392,1433,13,10,3
2016,1393,1433,10,10,0
2016,1396,1433,10,10,0
2016,1400,1433,6,10,-4
2016,1401,1433,3,10,-7
2016,1403,1433,8,10,-2
2016,1409,1433,11,10,1
2016,1421,1433,15,10,5
2016,1423,1433,13,10,3
2016,1425,1433,8,10,-2
2016,1428,1433,3,10,-7
2016,1112,1435,6,11,-5
2016,1114,1435,12,11,1
2016,1122,1435,16,11,5
2016,1124,1435,5,11,-6
2016,1138,1435,14,11,3
2016,1139,1435,9,11,-2
2016,1143,1435,4,11,-7
2016,1151,1435,12,11,1
2016,1153,1435,9,11,-2
2016,1160,1435,8,11,-3
2016,1163,1435,9,11,-2
2016,1167,1435,15,11,4
2016,1173,1435,7,11,-4
2016,1181,1435,4,11,-7
2016,1192,1435,16,11,5
2016,1195,1435,16,11,5
2016,1201,1435,14,11,3
2016,1211,1435,11,11,0
2016,1214,1435,16,11,5
2016,1218,1435,13,11,2
2016,1221,1435,16,11,5
2016,1231,1435,5,11,-6
2016,1233,1435,13,11,2
2016,1234,1435,7,11,-4
2016,1235,1435,4,11,-7
2016,1242,1435,1,11,-10
2016,1246,1435,4,11,-7
2016,1268,1435,5,11,-6
2016,1274,1435,3,11,-8
2016,1276,1435,11,11,0
2016,1277,1435,2,11,-9
2016,1292,1435,15,11,4
2016,1314,1435,1,11,-10
2016,1320,1435,11,11,0
2016,1323,1435,6,11,-5
2016,1328,1435,2,11,-9
2016,1332,1435,1,11,-10
2016,1333,1435,7,11,-4
2016,1338,1435,10,11,-1
2016,1344,1435,9,11,-2
2016,1345,1435,5,11,-6
2016,1355,1435,12,11,1
2016,1371,1435,6,11,-5
2016,1372,1435,14,11,3
2016,1380,1435,16,11,5
2016,1386,1435,8,11,-3
2016,1392,1435,13,11,2
2016,1393,1435,10,11,-1
2016,1396,1435,10,11,-1
2016,1400,1435,6,11,-5
2016,1401,1435,3,11,-8
2016,1403,1435,8,11,-3
2016,1409,1435,11,11,0
2016,1421,1435,15,11,4
2016,1423,1435,13,11,2
2016,1425,1435,8,11,-3
2016,1428,1435,3,11,-8
2016,1433,1435,10,11,-1
2016,1112,1437,6,2,4
2016,1114,1437,12,2,10
2016,1122,1437,16,2,14
2016,1124,1437,5,2,3
2016,1138,1437,14,2,12
2016,1139,1437,9,2,7
2016,1143,1437,4,2,2
2016,1151,1437,12,2,10
2016,1153,1437,9,2,7
2016,1160,1437,8,2,6
2016,1163,1437,9,2,7
2016,1167,1437,15,2,13
2016,1173,1437,7,2,5
2016,1181,1437,4,2,2
2016,1192,1437,16,2,14
2016,1195,1437,16,2,14
2016,1201,1437,14,2,12
2016,1211,1437,11,2,9
2016,1214,1437,16,2,14
2016,1218,1437,13,2,11
2016,1221,1437,16,2,14
2016,1231,1437,5,2,3
2016,1233,1437,13,2,11
2016,1234,1437,7,2,5
2016,1235,1437,4,2,2
2016,1242,1437,1,2,-1
2016,1246,1437,4,2,2
2016,1268,1437,5,2,3
2016,1274,1437,3,2,1
2016,1276,1437,11,2,9
2016,1277,1437,2,2,0
2016,1292,1437,15,2,13
2016,1314,1437,1,2,-1
2016,1320,1437,11,2,9
2016,1323,1437,6,2,4
2016,1328,1437,2,2,0
2016,1332,1437,1,2,-1
2016,1333,1437,7,2,5
2016,1338,1437,10,2,8
2016,1344,1437,9,2,7
2016,1345,1437,5,2,3
2016,1355,1437,12,2,10
2016,1371,1437,6,2,4
2016,1372,1437,14,2,12
2016,1380,1437,16,2,14
2016,1386,1437,8,2,6
2016,1392,1437,13,2,11
2016,1393,1437,10,2,8
2016,1396,1437,10,2,8
2016,1400,1437,6,2,4
2016,1401,1437,3,2,1
2016,1403,1437,8,2,6
2016,1409,1437,11,2,9
2016,1421,1437,15,2,13
2016,1423,1437,13,2,11
2016,1425,1437,8,2,6
2016,1428,1437,3,2,1
2016,1433,1437,10,2,8
2016,1435,1437,11,2,9
2016,1112,1438,6,1,5
2016,1114,1438,12,1,11
2016,1122,1438,16,1,15
2016,1124,1438,5,1,4
2016,1138,1438,14,1,13
2016,1139,1438,9,1,8
2016,1143,1438,4,1,3
2016,1151,1438,12,1,11
2016,1153,1438,9,1,8
2016,1160,1438,8,1,7
2016,1163,1438,9,1,8
2016,1167,1438,15,1,14
2016,1173,1438,7,1,6
2016,1181,1438,4,1,3
2016,1192,1438,16,1,15
2016,1195,1438,16,1,15
2016,1201,1438,14,1,13
2016,1211,1438,11,1,10
2016,1214,1438,16,1,15
2016,1218,1438,13,1,12
2016,1221,1438,16,1,15
2016,1231,1438,5,1,4
2016,1233,1438,13,1,12
2016,1234,1438,7,1,6
2016,1235,1438,4,1,3
2016,1242,1438,1,1,0
2016,1246,1438,4,1,3
2016,1268,1438,5,1,4
2016,1274,1438,3,1,2
2016,1276,1438,11,1,10
2016,1277,1438,2,1,1
2016,1292,1438,15,1,14
2016,1314,1438,1,1,0
2016,1320,1438,11,1,10
2016,1323,1438,6,1,5
2016,1328,1438,2,1,1
2016,1332,1438,1,1,0
2016,1333,1438,7,1,6
2016,1338,1438,10,1,9
2016,1344,1438,9,1,8
2016,1345,1438,5,1,4
2016,1355,1438,12,1,11
2016,1371,1438,6,1,5
2016,1372,1438,14,1,13
2016,1380,1438,16,1,15
2016,1386,1438,8,1,7
2016,1392,1438,13,1,12
2016,1393,1438,10,1,9
2016,1396,1438,10,1,9
2016,1400,1438,6,1,5
2016,1401,1438,3,1,2
2016,1403,1438,8,1,7
2016,1409,1438,11,1,10
2016,1421,1438,15,1,14
2016,1423,1438,13,1,12
2016,1425,1438,8,1,7
2016,1428,1438,3,1,2
2016,1433,1438,10,1,9
2016,1435,1438,11,1,10
2016,1437,1438,2,1,1
2016,1112,1451,6,15,-9
2016,1114,1451,12,15,-3
2016,1122,1451,16,15,1
2016,1124,1451,5,15,-10
2016,1138,1451,14,15,-1
2016,1139,1451,9,15,-6
2016,1143,1451,4,15,-11
2016,1151,1451,12,15,-3
2016,1153,1451,9,15,-6
2016,1160,1451,8,15,-7
2016,1163,1451,9,15,-6
2016,1167,1451,15,15,0
2016,1173,1451,7,15,-8
2016,1181,1451,4,15,-11
2016,1192,1451,16,15,1
2016,1195,1451,16,15,1
2016,1201,1451,14,15,-1
2016,1211,1451,11,15,-4
2016,1214,1451,16,15,1
2016,1218,1451,13,15,-2
2016,1221,1451,16,15,1
2016,1231,1451,5,15,-10
2016,1233,1451,13,15,-2
2016,1234,1451,7,15,-8
2016,1235,1451,4,15,-11
2016,1242,1451,1,15,-14
2016,1246,1451,4,15,-11
2016,1268,1451,5,15,-10
2016,1274,1451,3,15,-12
2016,1276,1451,11,15,-4
2016,1277,1451,2,15,-13
2016,1292,1451,15,15,0
2016,1314,1451,1,15,-14
2016,1320,1451,11,15,-4
2016,1323,1451,6,15,-9
2016,1328,1451,2,15,-13
2016,1332,1451,1,15,-14
2016,1333,1451,7,15,-8
2016,1338,1451,10,15,-5
2016,1344,1451,9,15,-6
2016,1345,1451,5,15,-10
2016,1355,1451,12,15,-3
2016,1371,1451,6,15,-9
2016,1372,1451,14,15,-1
2016,1380,1451,16,15,1
2016,1386,1451,8,15,-7
2016,1392,1451,13,15,-2
2016,1393,1451,10,15,-5
2016,1396,1451,10,15,-5
2016,1400,1451,6,15,-9
2016,1401,1451,3,15,-12
2016,1403,1451,8,15,-7
2016,1409,1451,11,15,-4
2016,1421,1451,15,15,0
2016,1423,1451,13,15,-2
2016,1425,1451,8,15,-7
2016,1428,1451,3,15,-12
2016,1433,1451,10,15,-5
2016,1435,1451,11,15,-4
2016,1437,1451,2,15,-13
2016,1438,1451,1,15,-14
2016,1112,1452,6,3,3
2016,1114,1452,12,3,9
2016,1122,1452,16,3,13
2016,1124,1452,5,3,2
2016,1138,1452,14,3,11
2016,1139,1452,9,3,6
2016,1143,1452,4,3,1
2016,1151,1452,12,3,9
2016,1153,1452,9,3,6
2016,1160,1452,8,3,5
2016,1163,1452,9,3,6
2016,1167,1452,15,3,12
2016,1173,1452,7,3,4
2016,1181,1452,4,3,1
2016,1192,1452,16,3,13
2016,1195,1452,16,3,13
2016,1201,1452,14,3,11
2016,1211,1452,11,3,8
2016,1214,1452,16,3,13
2016,1218,1452,13,3,10
2016,1221,1452,16,3,13
2016,1231,1452,5,3,2
2016,1233,1452,13,3,10
2016,1234,1452,7,3,4
2016,1235,1452,4,3,1
2016,1242,1452,1,3,-2
2016,1246,1452,4,3,1
2016,1268,1452,5,3,2
2016,1274,1452,3,3,0
2016,1276,1452,11,3,8
2016,1277,1452,2,3,-1
2016,1292,1452,15,3,12
2016,1314,1452,1,3,-2
2016,1320,1452,11,3,8
2016,1323,1452,6,3,3
2016,1328,1452,2,3,-1
2016,1332,1452,1,3,-2
2016,1333,1452,7,3,4
2016,1338,1452,10,3,7
2016,1344,1452,9,3,6
2016,1345,1452,5,3,2
2016,1355,1452,12,3,9
2016,1371,1452,6,3,3
2016,1372,1452,14,3,11
2016,1380,1452,16,3,13
2016,1386,1452,8,3,5
2016,1392,1452,13,3,10
2016,1393,1452,10,3,7
2016,1396,1452,10,3,7
2016,1400,1452,6,3,3
2016,1401,1452,3,3,0
2016,1403,1452,8,3,5
2016,1409,1452,11,3,8
2016,1421,1452,15,3,12
2016,1423,1452,13,3,10
2016,1425,1452,8,3,5
2016,1428,1452,3,3,0
2016,1433,1452,10,3,7
2016,1435,1452,11,3,8
2016,1437,1452,2,3,-1
2016,1438,1452,1,3,-2
2016,1451,1452,15,3,12
2016,1112,1453,6,14,-8
2016,1114,1453,12,14,-2
2016,1122,1453,16,14,2
2016,1124,1453,5,14,-9
2016,1138,1453,14,14,0
2016,1139,1453,9,14,-5
2016,1143,1453,4,14,-10
2016,1151,1453,12,14,-2
2016,1153,1453,9,14,-5
2016,1160,1453,8,14,-6
2016,1163,1453,9,14,-5
2016,1167,1453,15,14,1
2016,1173,1453,7,14,-7
2016,1181,1453,4,14,-10
2016,1192,1453,16,14,2
2016,1195,1453,16,14,2
2016,1201,1453,14,14,0
2016,1211,1453,11,14,-3
2016,1214,1453,16,14,2
2016,1218,1453,13,14,-1
2016,1221,1453,16,14,2
2016,1231,1453,5,14,-9
2016,1233,1453,13,14,-1
2016,1234,1453,7,14,-7
2016,1235,1453,4,14,-10
2016,1242,1453,1,14,-13
2016,1246,1453,4,14,-10
2016,1268,1453,5,14,-9
2016,1274,1453,3,14,-11
2016,1276,1453,11,14,-3
2016,1277,1453,2,14,-12
2016,1292,1453,15,14,1
2016,1314,1453,1,14,-13
2016,1320,1453,11,14,-3
2016,1323,1453,6,14,-8
2016,1328,1453,2,14,-12
2016,1332,1453,1,14,-13
2016,1333,1453,7,14,-7
2016,1338,1453,10,14,-4
2016,1344,1453,9,14,-5
2016,1345,1453,5,14,-9
2016,1355,1453,12,14,-2
2016,1371,1453,6,14,-8
2016,1372,1453,14,14,0
2016,1380,1453,16,14,2
2016,1386,1453,8,14,-6
2016,1392,1453,13,14,-1
2016,1393,1453,10,14,-4
2016,1396,1453,10,14,-4
2016,1400,1453,6,14,-8
2016,1401,1453,3,14,-11
2016,1403,1453,8,14,-6
2016,1409,1453,11,14,-3
2016,1421,1453,15,14,1
2016,1423,1453,13,14,-1
2016,1425,1453,8,14,-6
2016,1428,1453,3,14,-11
2016,1433,1453,10,14,-4
2016,1435,1453,11,14,-3
2016,1437,1453,2,14,-12
2016,1438,1453,1,14,-13
2016,1451,1453,15,14,1
2016,1452,1453,3,14,-11
2016,1112,1455,6,11,-5
2016,1114,1455,12,11,1
2016,1122,1455,16,11,5
2016,1124,1455,5,11,-6
2016,1138,1455,14,11,3
2016,1139,1455,9,11,-2
2016,1143,1455,4,11,-7
2016,1151,1455,12,11,1
2016,1153,1455,9,11,-2
2016,1160,1455,8,11,-3
2016,1163,1455,9,11,-2
2016,1167,1455,15,11,4
2016,1173,1455,7,11,-4
2016,1181,1455,4,11,-7
2016,1192,1455,16,11,5
2016,1195,1455,16,11,5
2016,1201,1455,14,11,3
2016,1211,1455,11,11,0
2016,1214,1455,16,11,5
2016,1218,1455,13,11,2
2016,1221,1455,16,11,5
2016,1231,1455,5,11,-6
2016,1233,1455,13,11,2
2016,1234,1455,7,11,-4
2016,1235,1455,4,11,-7
2016,1242,1455,1,11,-10
2016,1246,1455,4,11,-7
2016,1268,1455,5,11,-6
2016,1274,1455,3,11,-8
2016,1276,1455,11,11,0
2016,1277,1455,2,11,-9
2016,1292,1455,15,11,4
2016,1314,1455,1,11,-10
2016,1320,1455,11,11,0
2016,1323,1455,6,11,-5
2016,1328,1455,2,11,-9
2016,1332,1455,1,11,-10
2016,1333,1455,7,11,-4
2016,1338,1455,10,11,-1
2016,1344,1455,9,11,-2
2016,1345,1455,5,11,-6
2016,1355,1455,12,11,1
2016,1371,1455,6,11,-5
2016,1372,1455,14,11,3
2016,1380,1455,16,11,5
2016,1386,1455,8,11,-3
2016,1392,1455,13,11,2
2016,1393,1455,10,11,-1
2016,1396,1455,10,11,-1
2016,1400,1455,6,11,-5
2016,1401,1455,3,11,-8
2016,1403,1455,8,11,-3
2016,1409,1455,11,11,0
2016,1421,1455,15,11,4
2016,1423,1455,13,11,2
2016,1425,1455,8,11,-3
2016,1428,1455,3,11,-8
2016,1433,1455,10,11,-1
2016,1435,1455,11,11,0
2016,1437,1455,2,11,-9
2016,1438,1455,1,11,-10
2016,1451,1455,15,11,4
2016,1452,1455,3,11,-8
2016,1453,1455,14,11,3
2016,1112,1458,6,7,-1
2016,1114,1458,12,7,5
2016,1122,1458,16,7,9
2016,1124,1458,5,7,-2
2016,1138,1458,14,7,7
2016,1139,1458,9,7,2
2016,1143,1458,4,7,-3
2016,1151,1458,12,7,5
2016,1153,1458,9,7,2
2016,1160,1458,8,7,1
2016,1163,1458,9,7,2
2016,1167,1458,15,7,8
2016,1173,1458,7,7,0
2016,1181,1458,4,7,-3
2016,1192,1458,16,7,9
2016,1195,1458,16,7,9
2016,1201,1458,14,7,7
2016,1211,1458,11,7,4
2016,1214,1458,16,7,9
2016,1218,1458,13,7,6
2016,1221,1458,16,7,9
2016,1231,1458,5,7,-2
2016,1233,1458,13,7,6
2016,1234,1458,7,7,0
2016,1235,1458,4,7,-3
2016,1242,1458,1,7,-6
2016,1246,1458,4,7,-3
2016,1268,1458,5,7,-2
2016,1274,1458,3,7,-4
2016,1276,1458,11,7,4
2016,1277,1458,2,7,-5
2016,1292,1458,15,7,8
2016,1314,1458,1,7,-6
2016,1320,1458,11,7,4
2016,1323,1458,6,7,-1
2016,1328,1458,2,7,-5
2016,1332,1458,1,7,-6
2016,1333,1458,7,7,0
2016,1338,1458,10,7,3
2016,1344,1458,9,7,2
2016,1345,1458,5,7,-2
2016,1355,1458,12,7,5
2016,1371,1458,6,7,-1
2016,1372,1458,14,7,7
2016,1380,1458,16,7,9
2016,1386,1458,8,7,1
2016,1392,1458,13,7,6
2016,1393,1458,10,7,3
2016,1396,1458,10,7,3
2016,1400,1458,6,7,-1
2016,1401,1458,3,7,-4
2016,1403,1458,8,7,1
2016,1409,1458,11,7,4
2016,1421,1458,15,7,8
2016,1423,1458,13,7,6
2016,1425,1458,8,7,1
2016,1428,1458,3,7,-4
2016,1433,1458,10,7,3
2016,1435,1458,11,7,4
2016,1437,1458,2,7,-5
2016,1438,1458,1,7,-6
2016,1451,1458,15,7,8
2016,1452,1458,3,7,-4
2016,1453,1458,14,7,7
2016,1455,1458,11,7,4
2016,1112,1462,6,2,4
2016,1114,1462,12,2,10
2016,1122,1462,16,2,14
2016,1124,1462,5,2,3
2016,1138,1462,14,2,12
2016,1139,1462,9,2,7
2016,1143,1462,4,2,2
2016,1151,1462,12,2,10
2016,1153,1462,9,2,7
2016,1160,1462,8,2,6
2016,1163,1462,9,2,7
2016,1167,1462,15,2,13
2016,1173,1462,7,2,5
2016,1181,1462,4,2,2
2016,1192,1462,16,2,14
2016,1195,1462,16,2,14
2016,1201,1462,14,2,12
2016,1211,1462,11,2,9
2016,1214,1462,16,2,14
2016,1218,1462,13,2,11
2016,1221,1462,16,2,14
2016,1231,1462,5,2,3
2016,1233,1462,13,2,11
2016,1234,1462,7,2,5
2016,1235,1462,4,2,2
2016,1242,1462,1,2,-1
2016,1246,1462,4,2,2
2016,1268,1462,5,2,3
2016,1274,1462,3,2,1
2016,1276,1462,11,2,9
2016,1277,1462,2,2,0
2016,1292,1462,15,2,13
2016,1314,1462,1,2,-1
2016,1320,1462,11,2,9
2016,1323,1462,6,2,4
2016,1328,1462,2,2,0
2016,1332,1462,1,2,-1
2016,1333,1462,7,2,5
2016,1338,1462,10,2,8
2016,1344,1462,9,2,7
2016,1345,1462,5,2,3
2016,1355,1462,12,2,10
2016,1371,1462,6,2,4
2016,1372,1462,14,2,12
2016,1380,1462,16,2,14
2016,1386,1462,8,2,6
2016,1392,1462,13,2,11
2016,1393,1462,10,2,8
2016,1396,1462,10,2,8
2016,1400,1462,6,2,4
2016,1401,1462,3,2,1
2016,1403,1462,8,2,6
2016,1409,1462,11,2,9
2016,1421,1462,15,2,13
2016,1423,1462,13,2,11
2016,1425,1462,8,2,6
2016,1428,1462,3,2,1
2016,1433,1462,10,2,8
2016,1435,1462,11,2,9
2016,1437,1462,2,2,0
2016,1438,1462,1,2,-1
2016,1451,1462,15,2,13
2016,1452,1462,3,2,1
2016,1453,1462,14,2,12
2016,1455,1462,11,2,9
2016,1458,1462,7,2,5
2016,1112,1463,6,12,-6
2016,1114,1463,12,12,0
2016,1122,1463,16,12,4
2016,1124,1463,5,12,-7
2016,1138,1463,14,12,2
2016,1139,1463,9,12,-3
2016,1143,1463,4,12,-8
2016,1151,1463,12,12,0
2016,1153,1463,9,12,-3
2016,1160,1463,8,12,-4
2016,1163,1463,9,12,-3
2016,1167,1463,15,12,3
2016,1173,1463,7,12,-5
2016,1181,1463,4,12,-8
2016,1192,1463,16,12,4
2016,1195,1463,16,12,4
2016,1201,1463,14,12,2
2016,1211,1463,11,12,-1
2016,1214,1463,16,12,4
2016,1218,1463,13,12,1
2016,1221,1463,16,12,4
2016,1231,1463,5,12,-7
2016,1233,1463,13,12,1
2016,1234,1463,7,12,-5
2016,1235,1463,4,12,-8
2016,1242,1463,1,12,-11
2016,1246,1463,4,12,-8
2016,1268,1463,5,12,-7
2016,1274,1463,3,12,-9
2016,1276,1463,11,12,-1
2016,1277,1463,2,12,-10
2016,1292,1463,15,12,3
2016,1314,1463,1,12,-11
2016,1320,1463,11,12,-1
2016,1323,1463,6,12,-6
2016,1328,1463,2,12,-10
2016,1332,1463,1,12,-11
2016,1333,1463,7,12,-5
2016,1338,1463,10,12,-2
2016,1344,1463,9,12,-3
2016,1345,1463,5,12,-7
2016,1355,1463,12,12,0
2016,1371,1463,6,12,-6
2016,1372,1463,14,12,2
2016,1380,1463,16,12,4
2016,1386,1463,8,12,-4
2016,1392,1463,13,12,1
2016,1393,1463,10,12,-2
2016,1396,1463,10,12,-2
2016,1400,1463,6,12,-6
2016,1401,1463,3,12,-9
2016,1403,1463,8,12,-4
2016,1409,1463,11,12,-1
2016,1421,1463,15,12,3
2016,1423,1463,13,12,1
2016,1425,1463,8,12,-4
2016,1428,1463,3,12,-9
2016,1433,1463,10,12,-2
2016,1435,1463,11,12,-1
2016,1437,1463,2,12,-10
2016,1438,1463,1,12,-11
2016,1451,1463,15,12,3
2016,1452,1463,3,12,-9
2016,1453,1463,14,12,2
2016,1455,1463,11,12,-1
2016,1458,1463,7,12,-5
2016,1462,1463,2,12,-10
2017,1112,1116,2,8,-6
2017,1112,1124,2,3,-1
2017,1116,1124,8,3,5
2017,1112,1137,2,13,-11
2017,1116,1137,8,13,-5
2017,1124,1137,3,13,-10
2017,1112,1139,2,4,-2
2017,1116,1139,8,4,4
2017,1124,1139,3,4,-1
2017,1137,1139,13,4,9
2017,1112,1153,2,6,-4
2017,1116,1153,8,6,2
2017,1124,1153,3,6,-3
2017,1137,1153,13,6,7
2017,1139,1153,4,6,-2
2017,1112,1166,2,6,-4
2017,1116,1166,8,6,2
2017,1124,1166,3,6,-3
2017,1137,1166,13,6,7
2017,1139,1166,4,6,-2
2017,1153,1166,6,6,0
2017,1112,1173,2,7,-5
2017,1116,1173,8,7,1
2017,1124,1173,3,7,-4
2017,1137,1173,13,7,6
2017,1139,1173,4,7,-3
2017,1153,1173,6,7,-1
2017,1166,1173,6,7,-1
2017,1112,1181,2,2,0
2017,1116,1181,8,2,6
2017,1124,1181,3,2,1
2017,1137,1181,13,2,11
2017,1139,1181,4,2,2
2017,1153,1181,6,2,4
2017,1166,1181,6,2,4
2017,1173,1181,7,2,5
2017,1112,1190,2,13,-11
2017,1116,1190,8,13,-5
2017,1124,1190,3,13,-10
2017,1137,1190,13,13,0
2017,1139,1190,4,13,-9
2017,1153,1190,6,13,-7
2017,1166,1190,6,13,-7
2017,1173,1190,7,13,-6
2017,1181,1190,2,13,-11
2017,1112,1195,2,14,-12
2017,1116,1195,8,14,-6
2017,1124,1195,3,14,-11
2017,1137,1195,13,14,-1
2017,1139,1195,4,14,-10
2017,1153,1195,6,14,-8
2017,1166,1195,6,14,-8
2017,1173,1195,7,14,-7
2017,1181,1195,2,14,-12
2017,1190,1195,13,14,-1
2017,1112,1196,2,4,-2
2017,1116,1196,8,4,4
2017,1124,1196,3,4,-1
2017,1137,1196,13,4,9
2017,1139,1196,4,4,0
2017,1153,1196,6,4,2
2017,1166,1196,6,4,2
2017,1173,1196,7,4,3
2017,1181,1196,2,4,-2
2017,1190,1196,13,4,9
2017,1195,1196,14,4,10
2017,1112,1199,2,3,-1
2017,1116,1199,8,3,5
2017,1124,1199,3,3,0
2017,1137,1199,13,3,10
2017,1139,1199,4,3,1
2017,1153,1199,6,3,3
2017,1166,1199,6,3,3
2017,1173,1199,7,3,4
2017,1181,1199,2,3,-1
2017,1190,1199,13,3,10
2017,1195,1199,14,3,11
2017,1196,1199,4,3,1
2017,1112,1211,2,1,1
2017,1116,1211,8,1,7
2017,1124,1211,3,1,2
2017,1137,1211,13,1,12
2017,1139,1211,4,1,3
2017,1153,1211,6,1,5
2017,1166,1211,6,1,5
2017,1173,1211,7,1,6
2017,1181,1211,2,1,1
2017,1190,1211,13,1,12
2017,1195,1211,14,1,13
2017,1196,1211,4,1,3
2017,1199,1211,3,1,2
2017,1112,1233,2,14,-12
2017,1116,1233,8,14,-6
2017,1124,1233,3,14,-11
2017,1137,1233,13,14,-1
2017,1139,1233,4,14,-10
2017,1153,1233,6,14,-8
2017,1166,1233,6,14,-8
2017,1173,1233,7,14,-7
2017,1181,1233,2,14,-12
2017,1190,1233,13,14,-1
2017,1195,1233,14,14,0
2017,1196,1233,4,14,-10
2017,1199,1233,3,14,-11
2017,1211,1233,1,14,-13
2017,1112,1235,2,5,-3
2017,1116,1235,8,5,3
2017,1124,1235,3,5,-2
2017,1137,1235,13,5,8
2017,1139,1235,4,5,-1
2017,1153,1235,6,5,1
2017,1166,1235,6,5,1
2017,1173,1235,7,5,2
2017,1181,1235,2,5,-3
2017,1190,1235,13,5,8
2017,1195,1235,14,5,9
2017,1196,1235,4,5,-1
2017,1199,1235,3,5,-2
2017,1211,1235,1,5,-4
2017,1233,1235,14,5,9
2017,1112,1240,2,15,-13
2017,1116,1240,8,15,-7
2017,1124,1240,3,15,-12
2017,1137,1240,13,15,-2
2017,1139,1240,4,15,-11
2017,1153,1240,6,15,-9
2017,1166,1240,6,15,-9
2017,1173,1240,7,15,-8
2017,1181,1240,2,15,-13
2017,1190,1240,13,15,-2
2017,1195,1240,14,15,-1
2017,1196,1240,4,15,-11
2017,1199,1240,3,15,-12
2017,1211,1240,1,15,-14
2017,1233,1240,14,15,-1
2017,1235,1240,5,15,-10
2017,1112,1242,2,1,1
2017,1116,1242,8,1,7
2017,1124,1242,3,1,2
2017,1137,1242,13,1,12
2017,1139,1242,4,1,3
2017,1153,1242,6,1,5
2017,1166,1242,6,1,5
2017,1173,1242,7,1,6
2017,1181,1242,2,1,1
2017,1190,1242,13,1,12
2017,1195,1242,14,1,13
2017,1196,1242,4,1,3
2017,1199,1242,3,1,2
2017,1211,1242,1,1,0
2017,1233,1242,14,1,13
2017,1235,1242,5,1,4
2017,1240,1242,15,1,14
2017,1112,1243,2,11,-9
2017,1116,1243,8,11,-3
2017,1124,1243,3,11,-8
2017,1137,1243,13,11,2
2017,1139,1243,4,11,-7
2017,1153,1243,6,11,-5
2017,1166,1243,6,11,-5
2017,1173,1243,7,11,-4
2017,1181,1243,2,11,-9
2017,1190,1243,13,11,2
2017,1195,1243,14,11,3
2017,1196,1243,4,11,-7
2017,1199,1243,3,11,-8
2017,1211,1243,1,11,-10
2017,1233,1243,14,11,3
2017,1235,1243,5,11,-6
2017,1240,1243,15,11,4
2017,1242,1243,1,11,-10
2017,1112,1245,2,14,-12
2017,1116,1245,8,14,-6
2017,1124,1245,3,14,-11
2017,1137,1245,13,14,-1
2017,1139,1245,4,14,-10
2017,1153,1245,6,14,-8
2017,1166,1245,6,14,-8
2017,1173,1245,7,14,-7
2017,1181,1245,2,14,-12
2017,1190,1245,13,14,-1
2017,1195,1245,14,14,0
2017,1196,1245,4,14,-10
2017,1199,1245,3,14,-11
2017,1211,1245,1,14,-13
2017,1233,1245,14,14,0
2017,1235,1245,5,14,-9
2017,1240,1245,15,14,1
2017,1242,1245,1,14,-13
2017,1243,1245,11,14,-3
2017,1112,1246,2,2,0
2017,1116,1246,8,2,6
2017,1124,1246,3,2,1
2017,1137,1246,13,2,11
2017,1139,1246,4,2,2
2017,1153,1246,6,2,4
2017,1166,1246,6,2,4
2017,1173,1246,7,2,5
2017,1181,1246,2,2,0
2017,1190,1246,13,2,11
2017,1195,1246,14,2,12
2017,1196,1246,4,2,2
2017,1199,1246,3,2,1
2017,1211,1246,1,2,-1
2017,1233,1246,14,2,12
2017,1235,1246,5,2,3
2017,1240,1246,15,2,13
2017,1242,1246,1,2,-1
2017,1243,1246,11,2,9
2017,1245,1246,14,2,12
2017,1112,1257,2,2,0
2017,1116,1257,8,2,6
2017,1124,1257,3,2,1
2017,1137,1257,13,2,11
2017,1139,1257,4,2,2
2017,1153,1257,6,2,4
2017,1166,1257,6,2,4
2017,1173,1257,7,2,5
2017,1181,1257,2,2,0
2017,1190,1257,13,2,11
2017,1195,1257,14,2,12
2017,1196,1257,4,2,2
2017,1199,1257,3,2,1
2017,1211,1257,1,2,-1
2017,1233,1257,14,2,12
2017,1235,1257,5,2,3
2017,1240,1257,15,2,13
2017,1242,1257,1,2,-1
2017,1243,1257,11,2,9
2017,1245,1257,14,2,12
2017,1246,1257,2,2,0
2017,1112,1266,2,10,-8
2017,1116,1266,8,10,-2
2017,1124,1266,3,10,-7
2017,1137,1266,13,10,3
2017,1139,1266,4,10,-6
2017,1153,1266,6,10,-4
2017,1166,1266,6,10,-4
2017,1173,1266,7,10,-3
2017,1181,1266,2,10,-8
2017,1190,1266,13,10,3
2017,1195,1266,14,10,4
2017,1196,1266,4,10,-6
2017,1199,1266,3,10,-7
2017,1211,1266,1,10,-9
2017,1233,1266,14,10,4
2017,1235,1266,5,10,-5
2017,1240,1266,15,10,5
2017,1242,1266,1,10,-9
2017,1243,1266,11,10,1
2017,1245,1266,14,10,4
2017,1246,1266,2,10,-8
2017,1257,1266,2,10,-8
2017,1112,1268,2,6,-4
2017,1116,1268,8,6,2
2017,1124,1268,3,6,-3
2017,1137,1268,13,6,7
2017,1139,1268,4,6,-2
2017,1153,1268,6,6,0
2017,1166,1268,6,6,0
2017,1173,1268,7,6,1
2017,1181,1268,2,6,-4
2017,1190,1268,13,6,7
2017,1195,1268,14,6,8
2017,1196,1268,4,6,-2
2017,1199,1268,3,6,-3
2017,1211,1268,1,6,-5
2017,1233,1268,14,6,8
2017,1235,1268,5,6,-1
2017,1240,1268,15,6,9
2017,1242,1268,1,6,-5
2017,1243,1268,11,6,5
2017,1245,1268,14,6,8
2017,1246,1268,2,6,-4
2017,1257,1268,2,6,-4
2017,1266,1268,10,6,4
2017,1112,1274,2,8,-6
2017,1116,1274,8,8,0
2017,1124,1274,3,8,-5
2017,1137,1274,13,8,5
2017,1139,1274,4,8,-4
2017,1153,1274,6,8,-2
2017,1166,1274,6,8,-2
2017,1173,1274,7,8,-1
2017,1181,1274,2,8,-6
2017,1190,1274,13,8,5
2017,1195,1274,14,8,6
2017,1196,1274,4,8,-4
2017,1199,1274,3,8,-5
2017,1211,1274,1,8,-7
2017,1233,1274,14,8,6
2017,1235,1274,5,8,-3
2017,1240,1274,15,8,7
2017,1242,1274,1,8,-7
2017,1243,1274,11,8,3
2017,1245,1274,14,8,6
2017,1246,1274,2,8,-6
2017,1257,1274,2,8,-6
2017,1266,1274,10,8,2
2017,1268,1274,6,8,-2
2017,1112,1276,2,7,-5
2017,1116,1276,8,7,1
2017,1124,1276,3,7,-4
2017,1137,1276,13,7,6
2017,1139,1276,4,7,-3
2017,1153,1276,6,7,-1
2017,1166,1276,6,7,-1
2017,1173,1276,7,7,0
2017,1181,1276,2,7,-5
2017,1190,1276,13,7,6
2017,1195,1276,14,7,7
2017,1196,1276,4,7,-3
2017,1199,1276,3,7,-4
2017,1211,1276,1,7,-6
2017,1233,1276,14,7,7
2017,1235,1276,5,7,-2
2017,1240,1276,15,7,8
2017,1242,1276,1,7,-6
2017,1243,1276,11,7,4
2017,1245,1276,14,7,7
2017,1246,1276,2,7,-5
2017,1257,1276,2,7,-5
2017,1266,1276,10,7,3
2017,1268,1276,6,7,-1
2017,1274,1276,8,7,1
2017,1112,1277,2,9,-7
2017,1116,1277,8,9,-1
2017,1124,1277,3,9,-6
2017,1137,1277,13,9,4
2017,1139,1277,4,9,-5
2017,1153,1277,6,9,-3
2017,1166,1277,6,9,-3
2017,1173,1277,7,9,-2
2017,1181,1277,2,9,-7
2017,1190,1277,13,9,4
2017,1195,1277,14,9,5
2017,1196,1277,4,9,-5
2017,1199,1277,3,9,-6
2017,1211,1277,1,9,-8
2017,1233,1277,14,9,5
2017,1235,1277,5,9,-4
2017,1240,1277,15,9,6
2017,1242,1277,1,9,-8
2017,1243,1277,11,9,2
2017,1245,1277,14,9,5
2017,1246,1277,2,9,-7
2017,1257,1277,2,9,-7
2017,1266,1277,10,9,1
2017,1268,1277,6,9,-3
2017,1274,1277,8,9,-1
2017,1276,1277,7,9,-2
2017,1112,1278,2,5,-3
2017,1116,1278,8,5,3
2017,1124,1278,3,5,-2
2017,1137,1278,13,5,8
2017,1139,1278,4,5,-1
2017,1153,1278,6,5,1
2017,1166,1278,6,5,1
2017,1173,1278,7,5,2
2017,1181,1278,2,5,-3
2017,1190,1278,13,5,8
2017,1195,1278,14,5,9
2017,1196,1278,4,5,-1
2017,1199,1278,3,5,-2
2017,1211,1278,1,5,-4
2017,1233,1278,14,5,9
2017,1235,1278,5,5,0
2017,1240,1278,15,5,10
2017,1242,1278,1,5,-4
2017,1243,1278,11,5,6
2017,1245,1278,14,5,9
2017,1246,1278,2,5,-3
2017,1257,1278,2,5,-3
2017,1266,1278,10,5,5
2017,1268,1278,6,5,1
2017,1274,1278,8,5,3
2017,1276,1278,7,5,2
2017,1277,1278,9,5,4
2017,1112,1291,2,16,-14
2017,1116,1291,8,16,-8
2017,1124,1291,3,16,-13
2017,1137,1291,13,16,-3
2017,1139,1291,4,16,-12
2017,1153,1291,6,16,-10
2017,1166,1291,6,16,-10
2017,1173,1291,7,16,-9
2017,1181,1291,2,16,-14
2017,1190,1291,13,16,-3
2017,1195,1291,14,16,-2
2017,1196,1291,4,16,-12
2017,1199,1291,3,16,-13
2017,1211,1291,1,16,-15
2017,1233,1291,14,16,-2
2017,1235,1291,5,16,-11
2017,1240,1291,15,16,-1
2017,1242,1291,1,16,-15
2017,1243,1291,11,16,-5
2017,1245,1291,14,16,-2
2017,1246,1291,2,16,-14
2017,1257,1291,2,16,-14
2017,1266,1291,10,16,-6
2017,1268,1291,6,16,-10
2017,1274,1291,8,16,-8
2017,1276,1291,7,16,-9
2017,1277,1291,9,16,-7
2017,1278,1291,5,16,-11
2017,1112,1292,2,12,-10
2017,1116,1292,8,12,-4
2017,1124,1292,3,12,-9
2017,1137,1292,13,12,1
2017,1139,1292,4,12,-8
2017,1153,1292,6,12,-6
2017,1166,1292,6,12,-6
2017,1173,1292,7,12,-5
2017,1181,1292,2,12,-10
2017,1190,1292,13,12,1
2017,1195,1292,14,12,2
2017,1196,1292,4,12,-8
2017,1199,1292,3,12,-9
2017,1211,1292,1,12,-11
2017,1233,1292,14,12,2
2017,1235,1292,5,12,-7
2017,1240,1292,15,12,3
2017,1242,1292,1,12,-11
2017,1243,1292,11,12,-1
2017,1245,1292,14,12,2
2017,1246,1292,2,12,-10
2017,1257,1292,2,12,-10
2017,1266,1292,10,12,-2
2017,1268,1292,6,12,-6
2017,1274,1292,8,12,-4
2017,1276,1292,7,12,-5
2017,1277,1292,9,12,-3
2017,1278,1292,5,12,-7
2017,1291,1292,16,12,4
2017,1112,1297,2,15,-13
2017,1116,1297,8,15,-7
2017,1124,1297,3,15,-12
2017,1137,1297,13,15,-2
2017,1139,1297,4,15,-11
2017,1153,1297,6,15,-9
2017,1166,1297,6,15,-9
2017,1173,1297,7,15,-8
2017,1181,1297,2,15,-13
2017,1190,1297,13,15,-2
2017,1195,1297,14,15,-1
2017,1196,1297,4,15,-11
2017,1199,1297,3,15,-12
2017,1211,1297,1,15,-14
2017,1233,1297,14,15,-1
2017,1235,1297,5,15,-10
2017,1240,1297,15,15,0
2017,1242,1297,1,15,-14
2017,1243,1297,11,15,-4
2017,1245,1297,14,15,-1
2017,1246,1297,2,15,-13
2017,1257,1297,2,15,-13
2017,1266,1297,10,15,-5
2017,1268,1297,6,15,-9
2017,1274,1297,8,15,-7
2017,1276,1297,7,15,-8
2017,1277,1297,9,15,-6
2017,1278,1297,5,15,-10
2017,1291,1297,16,15,1
2017,1292,1297,12,15,-3
2017,1112,1300,2,16,-14
2017,1116,1300,8,16,-8
2017,1124,1300,3,16,-13
2017,1137,1300,13,16,-3
2017,1139,1300,4,16,-12
2017,1153,1300,6,16,-10
2017,1166,1300,6,16,-10
2017,1173,1300,7,16,-9
2017,1181,1300,2,16,-14
2017,1190,1300,13,16,-3
2017,1195,1300,14,16,-2
2017,1196,1300,4,16,-12
2017,1199,1300,3,16,-13
2017,1211,1300,1,16,-15
2017,1233,1300,14,16,-2
2017,1235,1300,5,16,-11
2017,1240,1300,15,16,-1
2017,1242,1300,1,16,-15
2017,1243,1300,11,16,-5
2017,1245,1300,14,16,-2
2017,1246,1300,2,16,-14
2017,1257,1300,2,16,-14
2017,1266,1300,10,16,-6
2017,1268,1300,6,16,-10
2017,1274,1300,8,16,-8
2017,1276,1300,7,16,-9
2017,1277,1300,9,16,-7
2017,1278,1300,5,16,-11
2017,1291,1300,16,16,0
2017,1292,1300,12,16,-4
2017,1297,1300,15,16,-1
2017,1112,1305,2,12,-10
2017,1116,1305,8,12,-4
2017,1124,1305,3,12,-9
2017,1137,1305,13,12,1
2017,1139,1305,4,12,-8
2017,1153,1305,6,12,-6
2017,1166,1305,6,12,-6
2017,1173,1305,7,12,-5
2017,1181,1305,2,12,-10
2017,1190,1305,13,12,1
2017,1195,1305,14,12,2
2017,1196,1305,4,12,-8
2017,1199,1305,3,12,-9
2017,1211,1305,1,12,-11
2017,1233,1305,14,12,2
2017,1235,1305,5,12,-7
2017,1240,1305,15,12,3
2017,1242,1305,1,12,-11
2017,1243,1305,11,12,-1
2017,1245,1305,14,12,2
2017,1246,1305,2,12,-10
2017,1257,1305,2,12,-10
2017,1266,1305,10,12,-2
2017,1268,1305,6,12,-6
2017,1274,1305,8,12,-4
2017,1276,1305,7,12,-5
2017,1277,1305,9,12,-3
2017,1278,1305,5,12,-7
2017,1291,1305,16,12,4
2017,1292,1305,12,12,0
2017,1297,1305,15,12,3
2017,1300,1305,16,12,4
2017,1112,1308,2,14,-12
2017,1116,1308,8,14,-6
2017,1124,1308,3,14,-11
2017,1137,1308,13,14,-1
2017,1139,1308,4,14,-10
2017,1153,1308,6,14,-8
2017,1166,1308,6,14,-8
2017,1173,1308,7,14,-7
2017,1181,1308,2,14,-12
2017,1190,1308,13,14,-1
2017,1195,1308,14,14,0
2017,1196,1308,4,14,-10
2017,1199,1308,3,14,-11
2017,1211,1308,1,14,-13
2017,1233,1308,14,14,0
2017,1235,1308,5,14,-9
2017,1240,1308,15,14,1
2017,1242,1308,1,14,-13
2017,1243,1308,11,14,-3
2017,1245,1308,14,14,0
2017,1246,1308,2,14,-12
2017,1257,1308,2,14,-12
2017,1266,1308,10,14,-4
2017,1268,1308,6,14,-8
2017,1274,1308,8,14,-6
2017,1276,1308,7,14,-7
2017,1277,1308,9,14,-5
2017,1278,1308,5,14,-9
2017,1291,1308,16,14,2
2017,1292,1308,12,14,-2
2017,1297,1308,15,14,1
2017,1300,1308,16,14,2
2017,1305,1308,12,14,-2
2017,1112,1309,2,16,-14
2017,1116,1309,8,16,-8
2017,1124,1309,3,16,-13
2017,1137,1309,13,16,-3
2017,1139,1309,4,16,-12
2017,1153,1309,6,16,-10
2017,1166,1309,6,16,-10
2017,1173,1309,7,16,-9
2017,1181,1309,2,16,-14
2017,1190,1309,13,16,-3
2017,1195,1309,14,16,-2
2017,1196,1309,4,16,-12
2017,1199,1309,3,16,-13
2017,1211,1309,1,16,-15
2017,1233,1309,14,16,-2
2017,1235,1309,5,16,-11
2017,1240,1309,15,16,-1
2017,1242,1309,1,16,-15
2017,1243,1309,11,16,-5
2017,1245,1309,14,16,-2
2017,1246,1309,2,16,-14
2017,1257,1309,2,16,-14
2017,1266,1309,10,16,-6
2017,1268,1309,6,16,-10
2017,1274,1309,8,16,-8
2017,1276,1309,7,16,-9
2017,1277,1309,9,16,-7
2017,1278,1309,5,16,-11
2017,1291,1309,16,16,0
2017,1292,1309,12,16,-4
2017,1297,1309,15,16,-1
2017,1300,1309,16,16,0
2017,1305,1309,12,16,-4
2017,1308,1309,14,16,-2
2017,1112,1314,2,1,1
2017,1116,1314,8,1,7
2017,1124,1314,3,1,2
2017,1137,1314,13,1,12
2017,1139,1314,4,1,3
2017,1153,1314,6,1,5
2017,1166,1314,6,1,5
2017,1173,1314,7,1,6
2017,1181,1314,2,1,1
2017,1190,1314,13,1,12
2017,1195,1314,14,1,13
2017,1196,1314,4,1,3
2017,1199,1314,3,1,2
2017,1211,1314,1,1,0
2017,1233,1314,14,1,13
2017,1235,1314,5,1,4
2017,1240,1314,15,1,14
2017,1242,1314,1,1,0
2017,1243,1314,11,1,10
2017,1245,1314,14,1,13
2017,1246,1314,2,1,1
2017,1257,1314,2,1,1
2017,1266,1314,10,1,9
2017,1268,1314,6,1,5
2017,1274,1314,8,1,7
2017,1276,1314,7,1,6
2017,1277,1314,9,1,8
2017,1278,1314,5,1,4
2017,1291,1314,16,1,15
2017,1292,1314,12,1,11
2017,1297,1314,15,1,14
2017,1300,1314,16,1,15
2017,1305,1314,12,1,11
2017,1308,1314,14,1,13
2017,1309,1314,16,1,15
2017,1112,1315,2,15,-13
2017,1116,1315,8,15,-7
2017,1124,1315,3,15,-12
2017,1137,1315,13,15,-2
2017,1139,1315,4,15,-11
2017,1153,1315,6,15,-9
2017,1166,1315,6,15,-9
2017,1173,1315,7,15,-8
2017,1181,1315,2,15,-13
2017,1190,1315,13,15,-2
2017,1195,1315,14,15,-1
2017,1196,1315,4,15,-11
2017,1199,1315,3,15,-12
2017,1211,1315,1,15,-14
2017,1233,1315,14,15,-1
2017,1235,1315,5,15,-10
2017,1240,1315,15,15,0
2017,1242,1315,1,15,-14
2017,1243,1315,11,15,-4
2017,1245,1315,14,15,-1
2017,1246,1315,2,15,-13
2017,1257,1315,2,15,-13
2017,1266,1315,10,15,-5
2017,1268,1315,6,15,-9
2017,1274,1315,8,15,-7
2017,1276,1315,7,15,-8
2017,1277,1315,9,15,-6
2017,1278,1315,5,15,-10
2017,1291,1315,16,15,1
2017,1292,1315,12,15,-3
2017,1297,1315,15,15,0
2017,1300,1315,16,15,1
2017,1305,1315,12,15,-3
2017,1308,1315,14,15,-1
2017,1309,1315,16,15,1
2017,1314,1315,1,15,-14
2017,1112,1321,2,8,-6
2017,1116,1321,8,8,0
2017,1124,1321,3,8,-5
2017,1137,1321,13,8,5
2017,1139,1321,4,8,-4
2017,1153,1321,6,8,-2
2017,1166,1321,6,8,-2
2017,1173,1321,7,8,-1
2017,1181,1321,2,8,-6
2017,1190,1321,13,8,5
2017,1195,1321,14,8,6
2017,1196,1321,4,8,-4
2017,1199,1321,3,8,-5
2017,1211,1321,1,8,-7
2017,1233,1321,14,8,6
2017,1235,1321,5,8,-3
2017,1240,1321,15,8,7
2017,1242,1321,1,8,-7
2017,1243,1321,11,8,3
2017,1245,1321,14,8,6
2017,1246,1321,2,8,-6
2017,1257,1321,2,8,-6
2017,1266,1321,10,8,2
2017,1268,1321,6,8,-2
2017,1274,1321,8,8,0
2017,1276,1321,7,8,-1
2017,1277,1321,9,8,1
2017,1278,1321,5,8,-3
2017,1291,1321,16,8,8
2017,1292,1321,12,8,4
2017,1297,1321,15,8,7
2017,1300,1321,16,8,8
2017,1305,1321,12,8,4
2017,1308,1321,14,8,6
2017,1309,1321,16,8,8
2017,1314,1321,1,8,-7
2017,1315,1321,15,8,7
2017,1112,1323,2,5,-3
2017,1116,1323,8,5,3
2017,1124,1323,3,5,-2
2017,1137,1323,13,5,8
2017,1139,1323,4,5,-1
2017,1153,1323,6,5,1
2017,1166,1323,6,5,1
2017,1173,1323,7,5,2
2017,1181,1323,2,5,-3
2017,1190,1323,13,5,8
2017,1195,1323,14,5,9
2017,1196,1323,4,5,-1
2017,1199,1323,3,5,-2
2017,1211,1323,1,5,-4
2017,1233,1323,14,5,9
2017,1235,1323,5,5,0
2017,1240,1323,15,5,10
2017,1242,1323,1,5,-4
2017,1243,1323,11,5,6
2017,1245,1323,14,5,9
2017,1246,1323,2,5,-3
2017,1257,1323,2,5,-3
2017,1266,1323,10,5,5
2017,1268,1323,6,5,1
2017,1274,1323,8,5,3
2017,1276,1323,7,5,2
2017,1277,1323,9,5,4
2017,1278,1323,5,5,0
2017,1291,1323,16,5,11
2017,1292,1323,12,5,7
2017,1297,1323,15,5,10
2017,1300,1323,16,5,11
2017,1305,1323,12,5,7
2017,1308,1323,14,5,9
2017,1309,1323,16,5,11
2017,1314,1323,1,5,-4
2017,1315,1323,15,5,10
2017,1321,1323,8,5,3
2017,1112,1329,2,10,-8
2017,1116,1329,8,10,-2
2017,1124,1329,3,10,-7
2017,1137,1329,13,10,3
2017,1139,1329,4,10,-6
2017,1153,1329,6,10,-4
2017,1166,1329,6,10,-4
2017,1173,1329,7,10,-3
2017,1181,1329,2,10,-8
2017,1190,1329,13,10,3
2017,1195,1329,14,10,4
2017,1196,1329,4,10,-6
2017,1199,1329,3,10,-7
2017,1211,1329,1,10,-9
2017,1233,1329,14,10,4
2017,1235,1329,5,10,-5
2017,1240,1329,15,10,5
2017,1242,1329,1,10,-9
2017,1243,1329,11,10,1
2017,1245,1329,14,10,4
2017,1246,1329,2,10,-8
2017,1257,1329,2,10,-8
2017,1266,1329,10,10,0
2017,1268,1329,6,10,-4
2017,1274,1329,8,10,-2
2017,1276,1329,7,10,-3
2017,1277,1329,9,10,-1
2017,1278,1329,5,10,-5
2017,1291,1329,16,10,6
2017,1292,1329,12,10,2
2017,1297,1329,15,10,5
2017,1300,1329,16,10,6
2017,1305,1329,12,10,2
2017,1308,1329,14,10,4
2017,1309,1329,16,10,6
2017,1314,1329,1,10,-9
2017,1315,1329,15,10,5
2017,1321,1329,8,10,-2
2017,1323,1329,5,10,-5
2017,1112,1332,2,3,-1
2017,1116,1332,8,3,5
2017,1124,1332,3,3,0
2017,1137,1332,13,3,10
2017,1139,1332,4,3,1
2017,1153,1332,6,3,3
2017,1166,1332,6,3,3
2017,1173,1332,7,3,4
2017,1181,1332,2,3,-1
2017,1190,1332,13,3,10
2017,1195,1332,14,3,11
2017,1196,1332,4,3,1
2017,1199,1332,3,3,0
2017,1211,1332,1,3,-2
2017,1233,1332,14,3,11
2017,1235,1332,5,3,2
2017,1240,1332,15,3,12
2017,1242,1332,1,3,-2
2017,1243,1332,11,3,8
2017,1245,1332,14,3,11
2017,1246,1332,2,3,-1
2017,1257,1332,2,3,-1
2017,1266,1332,10,3,7
2017,1268,1332,6,3,3
2017,1274,1332,8,3,5
2017,1276,1332,7,3,4
2017,1277,1332,9,3,6
2017,1278,1332,5,3,2
2017,1291,1332,16,3,13
2017,1292,1332,12,3,9
2017,1297,1332,15,3,12
2017,1300,1332,16,3,13
2017,1305,1332,12,3,9
2017,1308,1332,14,3,11
2017,1309,1332,16,3,13
2017,1314,1332,1,3,-2
2017,1315,1332,15,3,12
2017,1321,1332,8,3,5
2017,1323,1332,5,3,2
2017,1329,1332,10,3,7
2017,1112,1343,2,12,-10
2017,1116,1343,8,12,-4
2017,1124,1343,3,12,-9
2017,1137,1343,13,12,1
2017,1139,1343,4,12,-8
2017,1153,1343,6,12,-6
2017,1166,1343,6,12,-6
2017,1173,1343,7,12,-5
2017,1181,1343,2,12,-10
2017,1190,1343,13,12,1
2017,1195,1343,14,12,2
2017,1196,1343,4,12,-8
2017,1199,1343,3,12,-9
2017,1211,1343,1,12,-11
2017,1233,1343,14,12,2
2017,1235,1343,5,12,-7
2017,1240,1343,15,12,3
2017,1242,1343,1,12,-11
2017,1243,1343,11,12,-1
2017,1245,1343,14,12,2
2017,1246,1343,2,12,-10
2017,1257,1343,2,12,-10
2017,1266,1343,10,12,-2
2017,1268,1343,6,12,-6
2017,1274,1343,8,12,-4
2017,1276,1343,7,12,-5
2017,1277,1343,9,12,-3
2017,1278,1343,5,12,-7
2017,1291,1343,16,12,4
2017,1292,1343,12,12,0
2017,1297,1343,15,12,3
2017,1300,1343,16,12,4
2017,1305,1343,12,12,0
2017,1308,1343,14,12,2
2017,1309,1343,16,12,4
2017,1314,1343,1,12,-11
2017,1315,1343,15,12,3
2017,1321,1343,8,12,-4
2017,1323,1343,5,12,-7
2017,1329,1343,10,12,-2
2017,1332,1343,3,12,-9
2017,1112,1344,2,11,-9
2017,1116,1344,8,11,-3
2017,1124,1344,3,11,-8
2017,1137,1344,13,11,2
2017,1139,1344,4,11,-7
2017,1153,1344,6,11,-5
2017,1166,1344,6,11,-5
2017,1173,1344,7,11,-4
2017,1181,1344,2,11,-9
2017,1190,1344,13,11,2
2017,1195,1344,14,11,3
2017,1196,1344,4,11,-7
2017,1199,1344,3,11,-8
2017,1211,1344,1,11,-10
2017,1233,1344,14,11,3
2017,1235,1344,5,11,-6
2017,1240,1344,15,11,4
2017,1242,1344,1,11,-10
2017,1243,1344,11,11,0
2017,1245,1344,14,11,3
2017,1246,1344,2,11,-9
2017,1257,1344,2,11,-9
2017,1266,1344,10,11,-1
2017,1268,1344,6,11,-5
2017,1274,1344,8,11,-3
2017,1276,1344,7,11,-4
2017,1277,1344,9,11,-2
2017,1278,1344,5,11,-6
2017,1291,1344,16,11,5
2017,1292,1344,12,11,1
2017,1297,1344,15,11,4
2017,1300,1344,16,11,5
2017,1305,1344,12,11,1
2017,1308,1344,14,11,3
2017,1309,1344,16,11,5
2017,1314,1344,1,11,-10
2017,1315,1344,15,11,4
2017,1321,1344,8,11,-3
2017,1323,1344,5,11,-6
2017,1329,1344,10,11,-1
2017,1332,1344,3,11,-8
2017,1343,1344,12,11,1
2017,1112,1345,2,4,-2
2017,1116,1345,8,4,4
2017,1124,1345,3,4,-1
2017,1137,1345,13,4,9
2017,1139,1345,4,4,0
2017,1153,1345,6,4,2
2017,1166,1345,6,4,2
2017,1173,1345,7,4,3
2017,1181,1345,2,4,-2
2017,1190,1345,13,4,9
2017,1195,1345,14,4,10
2017,1196,1345,4,4,0
2017,1199,1345,3,4,-1
2017,1211,1345,1,4,-3
2017,1233,1345,14,4,10
2017,1235,1345,5,4,1
2017,1240,1345,15,4,11
2017,1242,1345,1,4,-3
2017,1243,1345,11,4,7
2017,1245,1345,14,4,10
2017,1246,1345,2,4,-2
2017,1257,1345,2,4,-2
2017,1266,1345,10,4,6
2017,1268,1345,6,4,2
2017,1274,1345,8,4,4
2017,1276,1345,7,4,3
2017,1277,1345,9,4,5
2017,1278,1345,5,4,1
2017,1291,1345,16,4,12
2017,1292,1345,12,4,8
2017,1297,1345,15,4,11
2017,1300,1345,16,4,12
2017,1305,1345,12,4,8
2017,1308,1345,14,4,10
2017,1309,1345,16,4,12
2017,1314,1345,1,4,-3
2017,1315,1345,15,4,11
2017,1321,1345,8,4,4
2017,1323,1345,5,4,1
2017,1329,1345,10,4,6
2017,1332,1345,3,4,-1
2017,1343,1345,12,4,8
2017,1344,1345,11,4,7
2017,1112,1348,2,11,-9
2017,1116,1348,8,11,-3
2017,1124,1348,3,11,-8
2017,1137,1348,13,11,2
2017,1139,1348,4,11,-7
2017,1153,1348,6,11,-5
2017,1166,1348,6,11,-5
2017,1173,1348,7,11,-4
2017,1181,1348,2,11,-9
2017,1190,1348,13,11,2
2017,1195,1348,14,11,3
2017,1196,1348,4,11,-7
2017,1199,1348,3,11,-8
2017,1211,1348,1,11,-10
2017,1233,1348,14,11,3
2017,1235,1348,5,11,-6
2017,1240,1348,15,11,4
2017,1242,1348,1,11,-10
2017,1243,1348,11,11,0
2017,1245,1348,14,11,3
2017,1246,1348,2,11,-9
2017,1257,1348,2,11,-9
2017,1266,1348,10,11,-1
2017,1268,1348,6,11,-5
2017,1274,1348,8,11,-3
2017,1276,1348,7,11,-4
2017,1277,1348,9,11,-2
2017,1278,1348,5,11,-6
2017,1291,1348,16,11,5
2017,1292,1348,12,11,1
2017,1297,1348,15,11,4
2017,1300,1348,16,11,5
2017,1305,1348,12,11,1
2017,1308,1348,14,11,3
2017,1309,1348,16,11,5
2017,1314,1348,1,11,-10
2017,1315,1348,15,11,4
2017,1321,1348,8,11,-3
2017,1323,1348,5,11,-6
2017,1329,1348,10,11,-1
2017,1332,1348,3,11,-8
2017,1343,1348,12,11,1
2017,1344,1348,11,11,0
2017,1345,1348,4,11,-7
2017,1112,1355,2,16,-14
2017,1116,1355,8,16,-8
2017,1124,1355,3,16,-13
2017,1137,1355,13,16,-3
2017,1139,1355,4,16,-12
2017,1153,1355,6,16,-10
2017,1166,1355,6,16,-10
2017,1173,1355,7,16,-9
2017,1181,1355,2,16,-14
2017,1190,1355,13,16,-3
2017,1195,1355,14,16,-2
2017,1196,1355,4,16,-12
2017,1199,1355,3,16,-13
2017,1211,1355,1,16,-15
2017,1233,1355,14,16,-2
2017,1235,1355,5,16,-11
2017,1240,1355,15,16,-1
2017,1242,1355,1,16,-15
2017,1243,1355,11,16,-5
2017,1245,1355,14,16,-2
2017,1246,1355,2,16,-14
2017,1257,1355,2,16,-14
2017,1266,1355,10,16,-6
2017,1268,1355,6,16,-10
2017,1274,1355,8,16,-8
2017,1276,1355,7,16,-9
2017,1277,1355,9,16,-7
2017,1278,1355,5,16,-11
2017,1291,1355,16,16,0
2017,1292,1355,12,16,-4
2017,1297,1355,15,16,-1
2017,1300,1355,16,16,0
2017,1305,1355,12,16,-4
2017,1308,1355,14,16,-2
2017,1309,1355,16,16,0
2017,1314,1355,1,16,-15
2017,1315,1355,15,16,-1
2017,1321,1355,8,16,-8
2017,1323,1355,5,16,-11
2017,1329,1355,10,16,-6
2017,1332,1355,3,16,-13
2017,1343,1355,12,16,-4
2017,1344,1355,11,16,-5
2017,1345,1355,4,16,-12
2017,1348,1355,11,16,-5
2017,1112,1371,2,9,-7
2017,1116,1371,8,9,-1
2017,1124,1371,3,9,-6
2017,1137,1371,13,9,4
2017,1139,1371,4,9,-5
2017,1153,1371,6,9,-3
2017,1166,1371,6,9,-3
2017,1173,1371,7,9,-2
2017,1181,1371,2,9,-7
2017,1190,1371,13,9,4
2017,1195,1371,14,9,5
2017,1196,1371,4,9,-5
2017,1199,1371,3,9,-6
2017,1211,1371,1,9,-8
2017,1233,1371,14,9,5
2017,1235,1371,5,9,-4
2017,1240,1371,15,9,6
2017,1242,1371,1,9,-8
2017,1243,1371,11,9,2
2017,1245,1371,14,9,5
2017,1246,1371,2,9,-7
2017,1257,1371,2,9,-7
2017,1266,1371,10,9,1
2017,1268,1371,6,9,-3
2017,1274,1371,8,9,-1
2017,1276,1371,7,9,-2
2017,1277,1371,9,9,0
2017,1278,1371,5,9,-4
2017,1291,1371,16,9,7
2017,1292,1371,12,9,3
2017,1297,1371,15,9,6
2017,1300,1371,16,9,7
2017,1305,1371,12,9,3
2017,1308,1371,14,9,5
2017,1309,1371,16,9,7
2017,1314,1371,1,9,-8
2017,1315,1371,15,9,6
2017,1321,1371,8,9,-1
2017,1323,1371,5,9,-4
2017,1329,1371,10,9,1
2017,1332,1371,3,9,-6
2017,1343,1371,12,9,3
2017,1344,1371,11,9,2
2017,1345,1371,4,9,-5
2017,1348,1371,11,9,2
2017,1355,1371,16,9,7
2017,1112,1374,2,6,-4
2017,1116,1374,8,6,2
2017,1124,1374,3,6,-3
2017,1137,1374,13,6,7
2017,1139,1374,4,6,-2
2017,1153,1374,6,6,0
2017,1166,1374,6,6,0
2017,1173,1374,7,6,1
2017,1181,1374,2,6,-4
2017,1190,1374,13,6,7
2017,1195,1374,14,6,8
2017,1196,1374,4,6,-2
2017,1199,1374,3,6,-3
2017,1211,1374,1,6,-5
2017,1233,1374,14,6,8
2017,1235,1374,5,6,-1
2017,1240,1374,15,6,9
2017,1242,1374,1,6,-5
2017,1243,1374,11,6,5
2017,1245,1374,14,6,8
2017,1246,1374,2,6,-4
2017,1257,1374,2,6,-4
2017,1266,1374,10,6,4
2017,1268,1374,6,6,0
2017,1274,1374,8,6,2
2017,1276,1374,7,6,1
2017,1277,1374,9,6,3
2017,1278,1374,5,6,-1
2017,1291,1374,16,6,10
2017,1292,1374,12,6,6
2017,1297,1374,15,6,9
2017,1300,1374,16,6,10
2017,1305,1374,12,6,6
2017,1308,1374,14,6,8
2017,1309,1374,16,6,10
2017,1314,1374,1,6,-5
2017,1315,1374,15,6,9
2017,1321,1374,8,6,2
2017,1323,1374,5,6,-1
2017,1329,1374,10,6,4
2017,1332,1374,3,6,-3
2017,1343,1374,12,6,6
2017,1344,1374,11,6,5
2017,1345,1374,4,6,-2
2017,1348,1374,11,6,5
2017,1355,1374,16,6,10
2017,1371,1374,9,6,3
2017,1112,1376,2,7,-5
2017,1116,1376,8,7,1
2017,1124,1376,3,7,-4
2017,1137,1376,13,7,6
2017,1139,1376,4,7,-3
2017,1153,1376,6,7,-1
2017,1166,1376,6,7,-1
2017,1173,1376,7,7,0
2017,1181,1376,2,7,-5
2017,1190,1376,13,7,6
2017,1195,1376,14,7,7
2017,1196,1376,4,7,-3
2017,1199,1376,3,7,-4
2017,1211,1376,1,7,-6
2017,1233,1376,14,7,7
2017,1235,1376,5,7,-2
2017,1240,1376,15,7,8
2017,1242,1376,1,7,-6
2017,1243,1376,11,7,4
2017,1245,1376,14,7,7
2017,1246,1376,2,7,-5
2017,1257,1376,2,7,-5
2017,1266,1376,10,7,3
2017,1268,1376,6,7,-1
2017,1274,1376,8,7,1
2017,1276,1376,7,7,0
2017,1277,1376,9,7,2
2017,1278,1376,5,7,-2
2017,1291,1376,16,7,9
2017,1292,1376,12,7,5
2017,1297,1376,15,7,8
2017,1300,1376,16,7,9
2017,1305,1376,12,7,5
2017,1308,1376,14,7,7
2017,1309,1376,16,7,9
2017,1314,1376,1,7,-6
2017,1315,1376,15,7,8
2017,1321,1376,8,7,1
2017,1323,1376,5,7,-2
2017,1329,1376,10,7,3
2017,1332,1376,3,7,-4
2017,1343,1376,12,7,5
2017,1344,1376,11,7,4
2017,1345,1376,4,7,-3
2017,1348,1376,11,7,4
2017,1355,1376,16,7,9
2017,1371,1376,9,7,2
2017,1374,1376,6,7,-1
2017,1112,1388,2,7,-5
2017,1116,1388,8,7,1
2017,1124,1388,3,7,-4
2017,1137,1388,13,7,6
2017,1139,1388,4,7,-3
2017,1153,1388,6,7,-1
2017,1166,1388,6,7,-1
2017,1173,1388,7,7,0
2017,1181,1388,2,7,-5
2017,1190,1388,13,7,6
2017,1195,1388,14,7,7
2017,1196,1388,4,7,-3
2017,1199,1388,3,7,-4
2017,1211,1388,1,7,-6
2017,1233,1388,14,7,7
2017,1235,1388,5,7,-2
2017,1240,1388,15,7,8
2017,1242,1388,1,7,-6
2017,1243,1388,11,7,4
2017,1245,1388,14,7,7
2017,1246,1388,2,7,-5
2017,1257,1388,2,7,-5
2017,1266,1388,10,7,3
2017,1268,1388,6,7,-1
2017,1274,1388,8,7,1
2017,1276,1388,7,7,0
2017,1277,1388,9,7,2
2017,1278,1388,5,7,-2
2017,1291,1388,16,7,9
2017,1292,1388,12,7,5
2017,1297,1388,15,7,8
2017,1300,1388,16,7,9
2017,1305,1388,12,7,5
2017,1308,1388,14,7,7
2017,1309,1388,16,7,9
2017,1314,1388,1,7,-6
2017,1315,1388,15,7,8
2017,1321,1388,8,7,1
2017,1323,1388,5,7,-2
2017,1329,1388,10,7,3
2017,1332,1388,3,7,-4
2017,1343,1388,12,7,5
2017,1344,1388,11,7,4
2017,1345,1388,4,7,-3
2017,1348,1388,11,7,4
2017,1355,1388,16,7,9
2017,1371,1388,9,7,2
2017,1374,1388,6,7,-1
2017,1376,1388,7,7,0
2017,1112,1407,2,15,-13
2017,1116,1407,8,15,-7
2017,1124,1407,3,15,-12
2017,1137,1407,13,15,-2
2017,1139,1407,4,15,-11
2017,1153,1407,6,15,-9
2017,1166,1407,6,15,-9
2017,1173,1407,7,15,-8
2017,1181,1407,2,15,-13
2017,1190,1407,13,15,-2
2017,1195,1407,14,15,-1
2017,1196,1407,4,15,-11
2017,1199,1407,3,15,-12
2017,1211,1407,1,15,-14
2017,1233,1407,14,15,-1
2017,1235,1407,5,15,-10
2017,1240,1407,15,15,0
2017,1242,1407,1,15,-14
2017,1243,1407,11,15,-4
2017,1245,1407,14,15,-1
2017,1246,1407,2,15,-13
2017,1257,1407,2,15,-13
2017,1266,1407,10,15,-5
2017,1268,1407,6,15,-9
2017,1274,1407,8,15,-7
2017,1276,1407,7,15,-8
2017,1277,1407,9,15,-6
2017,1278,1407,5,15,-10
2017,1291,1407,16,15,1
2017,1292,1407,12,15,-3
2017,1297,1407,15,15,0
2017,1300,1407,16,15,1
2017,1305,1407,12,15,-3
2017,1308,1407,14,15,-1
2017,1309,1407,16,15,1
2017,1314,1407,1,15,-14
2017,1315,1407,15,15,0
2017,1321,1407,8,15,-7
2017,1323,1407,5,15,-10
2017,1329,1407,10,15,-5
2017,1332,1407,3,15,-12
2017,1343,1407,12,15,-3
2017,1344,1407,11,15,-4
2017,1345,1407,4,15,-11
2017,1348,1407,11,15,-4
2017,1355,1407,16,15,1
2017,1371,1407,9,15,-6
2017,1374,1407,6,15,-9
2017,1376,1407,7,15,-8
2017,1388,1407,7,15,-8
2017,1112,1411,2,16,-14
2017,1116,1411,8,16,-8
2017,1124,1411,3,16,-13
2017,1137,1411,13,16,-3
2017,1139,1411,4,16,-12
2017,1153,1411,6,16,-10
2017,1166,1411,6,16,-10
2017,1173,1411,7,16,-9
2017,1181,1411,2,16,-14
2017,1190,1411,13,16,-3
2017,1195,1411,14,16,-2
2017,1196,1411,4,16,-12
2017,1199,1411,3,16,-13
2017,1211,1411,1,16,-15
2017,1233,1411,14,16,-2
2017,1235,1411,5,16,-11
2017,1240,1411,15,16,-1
2017,1242,1411,1,16,-15
2017,1243,1411,11,16,-5
2017,1245,1411,14,16,-2
2017,1246,1411,2,16,-14
2017,1257,1411,2,16,-14
2017,1266,1411,10,16,-6
2017,1268,1411,6,16,-10
2017,1274,1411,8,16,-8
2017,1276,1411,7,16,-9
2017,1277,1411,9,16,-7
2017,1278,1411,5,16,-11
2017,1291,1411,16,16,0
2017,1292,1411,12,16,-4
2017,1297,1411,15,16,-1
2017,1300,1411,16,16,0
2017,1305,1411,12,16,-4
2017,1308,1411,14,16,-2
2017,1309,1411,16,16,0
2017,1314,1411,1,16,-15
2017,1315,1411,15,16,-1
2017,1321,1411,8,16,-8
2017,1323,1411,5,16,-11
2017,1329,1411,10,16,-6
2017,1332,1411,3,16,-13
2017,1343,1411,12,16,-4
2017,1344,1411,11,16,-5
2017,1345,1411,4,16,-12
2017,1348,1411,11,16,-5
2017,1355,1411,16,16,0
2017,1371,1411,9,16,-7
2017,1374,1411,6,16,-10
2017,1376,1411,7,16,-9
2017,1388,1411,7,16,-9
2017,1407,1411,15,16,-1
2017,1112,1413,2,16,-14
2017,1116,1413,8,16,-8
2017,1124,1413,3,16,-13
2017,1137,1413,13,16,-3
2017,1139,1413,4,16,-12
2017,1153,1413,6,16,-10
2017,1166,1413,6,16,-10
2017,1173,1413,7,16,-9
2017,1181,1413,2,16,-14
2017,1190,1413,13,16,-3
2017,1195,1413,14,16,-2
2017,1196,1413,4,16,-12
2017,1199,1413,3,16,-13
2017,1211,1413,1,16,-15
2017,1233,1413,14,16,-2
2017,1235,1413,5,16,-11
2017,1240,1413,15,16,-1
2017,1242,1413,1,16,-15
2017,1243,1413,11,16,-5
2017,1245,1413,14,16,-2
2017,1246,1413,2,16,-14
2017,1257,1413,2,16,-14
2017,1266,1413,10,16,-6
2017,1268,1413,6,16,-10
2017,1274,1413,8,16,-8
2017,1276,1413,7,16,-9
2017,1277,1413,9,16,-7
2017,1278,1413,5,16,-11
2017,1291,1413,16,16,0
2017,1292,1413,12,16,-4
2017,1297,1413,15,16,-1
2017,1300,1413,16,16,0
2017,1305,1413,12,16,-4
2017,1308,1413,14,16,-2
2017,1309,1413,16,16,0
2017,1314,1413,1,16,-15
2017,1315,1413,15,16,-1
2017,1321,1413,8,16,-8
2017,1323,1413,5,16,-11
2017,1329,1413,10,16,-6
2017,1332,1413,3,16,-13
2017,1343,1413,12,16,-4
2017,1344,1413,11,16,-5
2017,1345,1413,4,16,-12
2017,1348,1413,11,16,-5
2017,1355,1413,16,16,0
2017,1371,1413,9,16,-7
2017,1374,1413,6,16,-10
2017,1376,1413,7,16,-9
2017,1388,1413,7,16,-9
2017,1407,1413,15,16,-1
2017,1411,1413,16,16,0
2017,1112,1417,2,3,-1
2017,1116,1417,8,3,5
2017,1124,1417,3,3,0
2017,1137,1417,13,3,10
2017,1139,1417,4,3,1
2017,1153,1417,6,3,3
2017,1166,1417,6,3,3
2017,1173,1417,7,3,4
2017,1181,1417,2,3,-1
2017,1190,1417,13,3,10
2017,1195,1417,14,3,11
2017,1196,1417,4,3,1
2017,1199,1417,3,3,0
2017,1211,1417,1,3,-2
2017,1233,1417,14,3,11
2017,1235,1417,5,3,2
2017,1240,1417,15,3,12
2017,1242,1417,1,3,-2
2017,1243,1417,11,3,8
2017,1245,1417,14,3,11
2017,1246,1417,2,3,-1
2017,1257,1417,2,3,-1
2017,1266,1417,10,3,7
2017,1268,1417,6,3,3
2017,1274,1417,8,3,5
2017,1276,1417,7,3,4
2017,1277,1417,9,3,6
2017,1278,1417,5,3,2
2017,1291,1417,16,3,13
2017,1292,1417,12,3,9
2017,1297,1417,15,3,12
2017,1300,1417,16,3,13
2017,1305,1417,12,3,9
2017,1308,1417,14,3,11
2017,1309,1417,16,3,13
2017,1314,1417,1,3,-2
2017,1315,1417,15,3,12
2017,1321,1417,8,3,5
2017,1323,1417,5,3,2
2017,1329,1417,10,3,7
2017,1332,1417,3,3,0
2017,1343,1417,12,3,9
2017,1344,1417,11,3,8
2017,1345,1417,4,3,1
2017,1348,1417,11,3,8
2017,1355,1417,16,3,13
2017,1371,1417,9,3,6
2017,1374,1417,6,3,3
2017,1376,1417,7,3,4
2017,1388,1417,7,3,4
2017,1407,1417,15,3,12
2017,1411,1417,16,3,13
2017,1413,1417,16,3,13
2017,1112,1423,2,12,-10
2017,1116,1423,8,12,-4
2017,1124,1423,3,12,-9
2017,1137,1423,13,12,1
2017,1139,1423,4,12,-8
2017,1153,1423,6,12,-6
2017,1166,1423,6,12,-6
2017,1173,1423,7,12,-5
2017,1181,1423,2,12,-10
2017,1190,1423,13,12,1
2017,1195,1423,14,12,2
2017,1196,1423,4,12,-8
2017,1199,1423,3,12,-9
2017,1211,1423,1,12,-11
2017,1233,1423,14,12,2
2017,1235,1423,5,12,-7
2017,1240,1423,15,12,3
2017,1242,1423,1,12,-11
2017,1243,1423,11,12,-1
2017,1245,1423,14,12,2
2017,1246,1423,2,12,-10
2017,1257,1423,2,12,-10
2017,1266,1423,10,12,-2
2017,1268,1423,6,12,-6
2017,1274,1423,8,12,-4
2017,1276,1423,7,12,-5
2017,1277,1423,9,12,-3
2017,1278,1423,5,12,-7
2017,1291,1423,16,12,4
2017,1292,1423,12,12,0
2017,1297,1423,15,12,3
2017,1300,1423,16,12,4
2017,1305,1423,12,12,0
2017,1308,1423,14,12,2
2017,1309,1423,16,12,4
2017,1314,1423,1,12,-11
2017,1315,1423,15,12,3
2017,1321,1423,8,12,-4
2017,1323,1423,5,12,-7
2017,1329,1423,10,12,-2
2017,1332,1423,3,12,-9
2017,1343,1423,12,12,0
2017,1344,1423,11,12,-1
2017,1345,1423,4,12,-8
2017,1348,1423,11,12,-1
2017,1355,1423,16,12,4
2017,1371,1423,9,12,-3
2017,1374,1423,6,12,-6
2017,1376,1423,7,12,-5
2017,1388,1423,7,12,-5
2017,1407,1423,15,12,3
2017,1411,1423,16,12,4
2017,1413,1423,16,12,4
2017,1417,1423,3,12,-9
2017,1112,1425,2,11,-9
2017,1116,1425,8,11,-3
2017,1124,1425,3,11,-8
2017,1137,1425,13,11,2
2017,1139,1425,4,11,-7
2017,1153,1425,6,11,-5
2017,1166,1425,6,11,-5
2017,1173,1425,7,11,-4
2017,1181,1425,2,11,-9
2017,1190,1425,13,11,2
2017,1195,1425,14,11,3
2017,1196,1425,4,11,-7
2017,1199,1425,3,11,-8
2017,1211,1425,1,11,-10
2017,1233,1425,14,11,3
2017,1235,1425,5,11,-6
2017,1240,1425,15,11,4
2017,1242,1425,1,11,-10
2017,1243,1425,11,11,0
2017,1245,1425,14,11,3
2017,1246,1425,2,11,-9
2017,1257,1425,2,11,-9
2017,1266,1425,10,11,-1
2017,1268,1425,6,11,-5
2017,1274,1425,8,11,-3
2017,1276,1425,7,11,-4
2017,1277,1425,9,11,-2
2017,1278,1425,5,11,-6
2017,1291,1425,16,11,5
2017,1292,1425,12,11,1
2017,1297,1425,15,11,4
2017,1300,1425,16,11,5
2017,1305,1425,12,11,1
2017,1308,1425,14,11,3
2017,1309,1425,16,11,5
2017,1314,1425,1,11,-10
2017,1315,1425,15,11,4
2017,1321,1425,8,11,-3
2017,1323,1425,5,11,-6
2017,1329,1425,10,11,-1
2017,1332,1425,3,11,-8
2017,1343,1425,12,11,1
2017,1344,1425,11,11,0
2017,1345,1425,4,11,-7
2017,1348,1425,11,11,0
2017,1355,1425,16,11,5
2017,1371,1425,9,11,-2
2017,1374,1425,6,11,-5
2017,1376,1425,7,11,-4
2017,1388,1425,7,11,-4
2017,1407,1425,15,11,4
2017,1411,1425,16,11,5
2017,1413,1425,16,11,5
2017,1417,1425,3,11,-8
2017,1423,1425,12,11,1
2017,1112,1433,2,10,-8
2017,1116,1433,8,10,-2
2017,1124,1433,3,10,-7
2017,1137,1433,13,10,3
2017,1139,1433,4,10,-6
2017,1153,1433,6,10,-4
2017,1166,1433,6,10,-4
2017,1173,1433,7,10,-3
2017,1181,1433,2,10,-8
2017,1190,1433,13,10,3
2017,1195,1433,14,10,4
2017,1196,1433,4,10,-6
2017,1199,1433,3,10,-7
2017,1211,1433,1,10,-9
2017,1233,1433,14,10,4
2017,1235,1433,5,10,-5
2017,1240,1433,15,10,5
2017,1242,1433,1,10,-9
2017,1243,1433,11,10,1
2017,1245,1433,14,10,4
2017,1246,1433,2,10,-8
2017,1257,1433,2,10,-8
2017,1266,1433,10,10,0
2017,1268,1433,6,10,-4
2017,1274,1433,8,10,-2
2017,1276,1433,7,10,-3
2017,1277,1433,9,10,-1
2017,1278,1433,5,10,-5
2017,1291,1433,16,10,6
2017,1292,1433,12,10,2
2017,1297,1433,15,10,5
2017,1300,1433,16,10,6
2017,1305,1433,12,10,2
2017,1308,1433,14,10,4
2017,1309,1433,16,10,6
2017,1314,1433,1,10,-9
2017,1315,1433,15,10,5
2017,1321,1433,8,10,-2
2017,1323,1433,5,10,-5
2017,1329,1433,10,10,0
2017,1332,1433,3,10,-7
2017,1343,1433,12,10,2
2017,1344,1433,11,10,1
2017,1345,1433,4,10,-6
2017,1348,1433,11,10,1
2017,1355,1433,16,10,6
2017,1371,1433,9,10,-1
2017,1374,1433,6,10,-4
2017,1376,1433,7,10,-3
2017,1388,1433,7,10,-3
2017,1407,1433,15,10,5
2017,1411,1433,16,10,6
2017,1413,1433,16,10,6
2017,1417,1433,3,10,-7
2017,1423,1433,12,10,2
2017,1425,1433,11,10,1
2017,1112,1435,2,9,-7
2017,1116,1435,8,9,-1
2017,1124,1435,3,9,-6
2017,1137,1435,13,9,4
2017,1139,1435,4,9,-5
2017,1153,1435,6,9,-3
2017,1166,1435,6,9,-3
2017,1173,1435,7,9,-2
2017,1181,1435,2,9,-7
2017,1190,1435,13,9,4
2017,1195,1435,14,9,5
2017,1196,1435,4,9,-5
2017,1199,1435,3,9,-6
2017,1211,1435,1,9,-8
2017,1233,1435,14,9,5
2017,1235,1435,5,9,-4
2017,1240,1435,15,9,6
2017,1242,1435,1,9,-8
2017,1243,1435,11,9,2
2017,1245,1435,14,9,5
2017,1246,1435,2,9,-7
2017,1257,1435,2,9,-7
2017,1266,1435,10,9,1
2017,1268,1435,6,9,-3
2017,1274,1435,8,9,-1
2017,1276,1435,7,9,-2
2017,1277,1435,9,9,0
2017,1278,1435,5,9,-4
2017,1291,1435,16,9,7
2017,1292,1435,12,9,3
2017,1297,1435,15,9,6
2017,1300,1435,16,9,7
2017,1305,1435,12,9,3
2017,1308,1435,14,9,5
2017,1309,1435,16,9,7
2017,1314,1435,1,9,-8
2017,1315,1435,15,9,6
2017,1321,1435,8,9,-1
2017,1323,1435,5,9,-4
2017,1329,1435,10,9,1
2017,1332,1435,3,9,-6
2017,1343,1435,12,9,3
2017,1344,1435,11,9,2
2017,1345,1435,4,9,-5
2017,1348,1435,11,9,2
2017,1355,1435,16,9,7
2017,1371,1435,9,9,0
2017,1374,1435,6,9,-3
2017,1376,1435,7,9,-2
2017,1388,1435,7,9,-2
2017,1407,1435,15,9,6
2017,1411,1435,16,9,7
2017,1413,1435,16,9,7
2017,1417,1435,3,9,-6
2017,1423,1435,12,9,3
2017,1425,1435,11,9,2
2017,1433,1435,10,9,1
2017,1112,1436,2,13,-11
2017,1116,1436,8,13,-5
2017,1124,1436,3,13,-10
2017,1137,1436,13,13,0
2017,1139,1436,4,13,-9
2017,1153,1436,6,13,-7
2017,1166,1436,6,13,-7
2017,1173,1436,7,13,-6
2017,1181,1436,2,13,-11
2017,1190,1436,13,13,0
2017,1195,1436,14,13,1
2017,1196,1436,4,13,-9
2017,1199,1436,3,13,-10
2017,1211,1436,1,13,-12
2017,1233,1436,14,13,1
2017,1235,1436,5,13,-8
2017,1240,1436,15,13,2
2017,1242,1436,1,13,-12
2017,1243,1436,11,13,-2
2017,1245,1436,14,13,1
2017,1246,1436,2,13,-11
2017,1257,1436,2,13,-11
2017,1266,1436,10,13,-3
2017,1268,1436,6,13,-7
2017,1274,1436,8,13,-5
2017,1276,1436,7,13,-6
2017,1277,1436,9,13,-4
2017,1278,1436,5,13,-8
2017,1291,1436,16,13,3
2017,1292,1436,12,13,-1
2017,1297,1436,15,13,2
2017,1300,1436,16,13,3
2017,1305,1436,12,13,-1
2017,1308,1436,14,13,1
2017,1309,1436,16,13,3
2017,1314,1436,1,13,-12
2017,1315,1436,15,13,2
2017,1321,1436,8,13,-5
2017,1323,1436,5,13,-8
2017,1329,1436,10,13,-3
2017,1332,1436,3,13,-10
2017,1343,1436,12,13,-1
2017,1344,1436,11,13,-2
2017,1345,1436,4,13,-9
2017,1348,1436,11,13,-2
2017,1355,1436,16,13,3
2017,1371,1436,9,13,-4
2017,1374,1436,6,13,-7
2017,1376,1436,7,13,-6
2017,1388,1436,7,13,-6
2017,1407,1436,15,13,2
2017,1411,1436,16,13,3
2017,1413,1436,16,13,3
2017,1417,1436,3,13,-10
2017,1423,1436,12,13,-1
2017,1425,1436,11,13,-2
2017,1433,1436,10,13,-3
2017,1435,1436,9,13,-4
2017,1112,1437,2,1,1
2017,1116,1437,8,1,7
2017,1124,1437,3,1,2
2017,1137,1437,13,1,12
2017,1139,1437,4,1,3
2017,1153,1437,6,1,5
2017,1166,1437,6,1,5
2017,1173,1437,7,1,6
2017,1181,1437,2,1,1
2017,1190,1437,13,1,12
2017,1195,1437,14,1,13
2017,1196,1437,4,1,3
2017,1199,1437,3,1,2
2017,1211,1437,1,1,0
2017,1233,1437,14,1,13
2017,1235,1437,5,1,4
2017,1240,1437,15,1,14
2017,1242,1437,1,1,0
2017,1243,1437,11,1,10
2017,1245,1437,14,1,13
2017,1246,1437,2,1,1
2017,1257,1437,2,1,1
2017,1266,1437,10,1,9
2017,1268,1437,6,1,5
2017,1274,1437,8,1,7
2017,1276,1437,7,1,6
2017,1277,1437,9,1,8
2017,1278,1437,5,1,4
2017,1291,1437,16,1,15
2017,1292,1437,12,1,11
2017,1297,1437,15,1,14
2017,1300,1437,16,1,15
2017,1305,1437,12,1,11
2017,1308,1437,14,1,13
2017,1309,1437,16,1,15
2017,1314,1437,1,1,0
2017,1315,1437,15,1,14
2017,1321,1437,8,1,7
2017,1323,1437,5,1,4
2017,1329,1437,10,1,9
2017,1332,1437,3,1,2
2017,1343,1437,12,1,11
2017,1344,1437,11,1,10
2017,1345,1437,4,1,3
2017,1348,1437,11,1,10
2017,1355,1437,16,1,15
2017,1371,1437,9,1,8
2017,1374,1437,6,1,5
2017,1376,1437,7,1,6
2017,1388,1437,7,1,6
2017,1407,1437,15,1,14
2017,1411,1437,16,1,15
2017,1413,1437,16,1,15
2017,1417,1437,3,1,2
2017,1423,1437,12,1,11
2017,1425,1437,11,1,10
2017,1433,1437,10,1,9
2017,1435,1437,9,1,8
2017,1436,1437,13,1,12
2017,1112,1438,2,5,-3
2017,1116,1438,8,5,3
2017,1124,1438,3,5,-2
2017,1137,1438,13,5,8
2017,1139,1438,4,5,-1
2017,1153,1438,6,5,1
2017,1166,1438,6,5,1
2017,1173,1438,7,5,2
2017,1181,1438,2,5,-3
2017,1190,1438,13,5,8
2017,1195,1438,14,5,9
2017,1196,1438,4,5,-1
2017,1199,1438,3,5,-2
2017,1211,1438,1,5,-4
2017,1233,1438,14,5,9
2017,1235,1438,5,5,0
2017,1240,1438,15,5,10
2017,1242,1438,1,5,-4
2017,1243,1438,11,5,6
2017,1245,1438,14,5,9
2017,1246,1438,2,5,-3
2017,1257,1438,2,5,-3
2017,1266,1438,10,5,5
2017,1268,1438,6,5,1
2017,1274,1438,8,5,3
2017,1276,1438,7,5,2
2017,1277,1438,9,5,4
2017,1278,1438,5,5,0
2017,1291,1438,16,5,11
2017,1292,1438,12,5,7
2017,1297,1438,15,5,10
2017,1300,1438,16,5,11
2017,1305,1438,12,5,7
2017,1308,1438,14,5,9
2017,1309,1438,16,5,11
2017,1314,1438,1,5,-4
2017,1315,1438,15,5,10
2017,1321,1438,8,5,3
2017,1323,1438,5,5,0
2017,1329,1438,10,5,5
2017,1332,1438,3,5,-2
2017,1343,1438,12,5,7
2017,1344,1438,11,5,6
2017,1345,1438,4,5,-1
2017,1348,1438,11,5,6
2017,1355,1438,16,5,11
2017,1371,1438,9,5,4
2017,1374,1438,6,5,1
2017,1376,1438,7,5,2
2017,1388,1438,7,5,2
2017,1407,1438,15,5,10
2017,1411,1438,16,5,11
2017,1413,1438,16,5,11
2017,1417,1438,3,5,-2
2017,1423,1438,12,5,7
2017,1425,1438,11,5,6
2017,1433,1438,10,5,5
2017,1435,1438,9,5,4
2017,1436,1438,13,5,8
2017,1437,1438,1,5,-4
2017,1112,1439,2,9,-7
2017,1116,1439,8,9,-1
2017,1124,1439,3,9,-6
2017,1137,1439,13,9,4
2017,1139,1439,4,9,-5
2017,1153,1439,6,9,-3
2017,1166,1439,6,9,-3
2017,1173,1439,7,9,-2
2017,1181,1439,2,9,-7
2017,1190,1439,13,9,4
2017,1195,1439,14,9,5
2017,1196,1439,4,9,-5
2017,1199,1439,3,9,-6
2017,1211,1439,1,9,-8
2017,1233,1439,14,9,5
2017,1235,1439,5,9,-4
2017,1240,1439,15,9,6
2017,1242,1439,1,9,-8
2017,1243,1439,11,9,2
2017,1245,1439,14,9,5
2017,1246,1439,2,9,-7
2017,1257,1439,2,9,-7
2017,1266,1439,10,9,1
2017,1268,1439,6,9,-3
2017,1274,1439,8,9,-1
2017,1276,1439,7,9,-2
2017,1277,1439,9,9,0
2017,1278,1439,5,9,-4
2017,1291,1439,16,9,7
2017,1292,1439,12,9,3
2017,1297,1439,15,9,6
2017,1300,1439,16,9,7
2017,1305,1439,12,9,3
2017,1308,1439,14,9,5
2017,1309,1439,16,9,7
2017,1314,1439,1,9,-8
2017,1315,1439,15,9,6
2017,1321,1439,8,9,-1
2017,1323,1439,5,9,-4
2017,1329,1439,10,9,1
2017,1332,1439,3,9,-6
2017,1343,1439,12,9,3
2017,1344,1439,11,9,2
2017,1345,1439,4,9,-5
2017,1348,1439,11,9,2
2017,1355,1439,16,9,7
2017,1371,1439,9,9,0
2017,1374,1439,6,9,-3
2017,1376,1439,7,9,-2
2017,1388,1439,7,9,-2
2017,1407,1439,15,9,6
2017,1411,1439,16,9,7
2017,1413,1439,16,9,7
2017,1417,1439,3,9,-6
2017,1423,1439,12,9,3
2017,1425,1439,11,9,2
2017,1433,1439,10,9,1
2017,1435,1439,9,9,0
2017,1436,1439,13,9,4
2017,1437,1439,1,9,-8
2017,1438,1439,5,9,-4
2017,1112,1448,2,11,-9
2017,1116,1448,8,11,-3
2017,1124,1448,3,11,-8
2017,1137,1448,13,11,2
2017,1139,1448,4,11,-7
2017,1153,1448,6,11,-5
2017,1166,1448,6,11,-5
2017,1173,1448,7,11,-4
2017,1181,1448,2,11,-9
2017,1190,1448,13,11,2
2017,1195,1448,14,11,3
2017,1196,1448,4,11,-7
2017,1199,1448,3,11,-8
2017,1211,1448,1,11,-10
2017,1233,1448,14,11,3
2017,1235,1448,5,11,-6
2017,1240,1448,15,11,4
2017,1242,1448,1,11,-10
2017,1243,1448,11,11,0
2017,1245,1448,14,11,3
2017,1246,1448,2,11,-9
2017,1257,1448,2,11,-9
2017,1266,1448,10,11,-1
2017,1268,1448,6,11,-5
2017,1274,1448,8,11,-3
2017,1276,1448,7,11,-4
2017,1277,1448,9,11,-2
2017,1278,1448,5,11,-6
2017,1291,1448,16,11,5
2017,1292,1448,12,11,1
2017,1297,1448,15,11,4
2017,1300,1448,16,11,5
2017,1305,1448,12,11,1
2017,1308,1448,14,11,3
2017,1309,1448,16,11,5
2017,1314,1448,1,11,-10
2017,1315,1448,15,11,4
2017,1321,1448,8,11,-3
2017,1323,1448,5,11,-6
2017,1329,1448,10,11,-1
2017,1332,1448,3,11,-8
2017,1343,1448,12,11,1
2017,1344,1448,11,11,0
2017,1345,1448,4,11,-7
2017,1348,1448,11,11,0
2017,1355,1448,16,11,5
2017,1371,1448,9,11,-2
2017,1374,1448,6,11,-5
2017,1376,1448,7,11,-4
2017,1388,1448,7,11,-4
2017,1407,1448,15,11,4
2017,1411,1448,16,11,5
2017,1413,1448,16,11,5
2017,1417,1448,3,11,-8
2017,1423,1448,12,11,1
2017,1425,1448,11,11,0
2017,1433,1448,10,11,-1
2017,1435,1448,9,11,-2
2017,1436,1448,13,11,2
2017,1437,1448,1,11,-10
2017,1438,1448,5,11,-6
2017,1439,1448,9,11,-2
2017,1112,1452,2,4,-2
2017,1116,1452,8,4,4
2017,1124,1452,3,4,-1
2017,1137,1452,13,4,9
2017,1139,1452,4,4,0
2017,1153,1452,6,4,2
2017,1166,1452,6,4,2
2017,1173,1452,7,4,3
2017,1181,1452,2,4,-2
2017,1190,1452,13,4,9
2017,1195,1452,14,4,10
2017,1196,1452,4,4,0
2017,1199,1452,3,4,-1
2017,1211,1452,1,4,-3
2017,1233,1452,14,4,10
2017,1235,1452,5,4,1
2017,1240,1452,15,4,11
2017,1242,1452,1,4,-3
2017,1243,1452,11,4,7
2017,1245,1452,14,4,10
2017,1246,1452,2,4,-2
2017,1257,1452,2,4,-2
2017,1266,1452,10,4,6
2017,1268,1452,6,4,2
2017,1274,1452,8,4,4
2017,1276,1452,7,4,3
2017,1277,1452,9,4,5
2017,1278,1452,5,4,1
2017,1291,1452,16,4,12
2017,1292,1452,12,4,8
2017,1297,1452,15,4,11
2017,1300,1452,16,4,12
2017,1305,1452,12,4,8
2017,1308,1452,14,4,10
2017,1309,1452,16,4,12
2017,1314,1452,1,4,-3
2017,1315,1452,15,4,11
2017,1321,1452,8,4,4
2017,1323,1452,5,4,1
2017,1329,1452,10,4,6
2017,1332,1452,3,4,-1
2017,1343,1452,12,4,8
2017,1344,1452,11,4,7
2017,1345,1452,4,4,0
2017,1348,1452,11,4,7
2017,1355,1452,16,4,12
2017,1371,1452,9,4,5
2017,1374,1452,6,4,2
2017,1376,1452,7,4,3
2017,1388,1452,7,4,3
2017,1407,1452,15,4,11
2017,1411,1452,16,4,12
2017,1413,1452,16,4,12
2017,1417,1452,3,4,-1
2017,1423,1452,12,4,8
2017,1425,1452,11,4,7
2017,1433,1452,10,4,6
2017,1435,1452,9,4,5
2017,1436,1452,13,4,9
2017,1437,1452,1,4,-3
2017,1438,1452,5,4,1
2017,1439,1452,9,4,5
2017,1448,1452,11,4,7
2017,1112,1455,2,10,-8
2017,1116,1455,8,10,-2
2017,1124,1455,3,10,-7
2017,1137,1455,13,10,3
2017,1139,1455,4,10,-6
2017,1153,1455,6,10,-4
2017,1166,1455,6,10,-4
2017,1173,1455,7,10,-3
2017,1181,1455,2,10,-8
2017,1190,1455,13,10,3
2017,1195,1455,14,10,4
2017,1196,1455,4,10,-6
2017,1199,1455,3,10,-7
2017,1211,1455,1,10,-9
2017,1233,1455,14,10,4
2017,1235,1455,5,10,-5
2017,1240,1455,15,10,5
2017,1242,1455,1,10,-9
2017,1243,1455,11,10,1
2017,1245,1455,14,10,4
2017,1246,1455,2,10,-8
2017,1257,1455,2,10,-8
2017,1266,1455,10,10,0
2017,1268,1455,6,10,-4
2017,1274,1455,8,10,-2
2017,1276,1455,7,10,-3
2017,1277,1455,9,10,-1
2017,1278,1455,5,10,-5
2017,1291,1455,16,10,6
2017,1292,1455,12,10,2
2017,1297,1455,15,10,5
2017,1300,1455,16,10,6
2017,1305,1455,12,10,2
2017,1308,1455,14,10,4
2017,1309,1455,16,10,6
2017,1314,1455,1,10,-9
2017,1315,1455,15,10,5
2017,1321,1455,8,10,-2
2017,1323,1455,5,10,-5
2017,1329,1455,10,10,0
2017,1332,1455,3,10,-7
2017,1343,1455,12,10,2
2017,1344,1455,11,10,1
2017,1345,1455,4,10,-6
2017,1348,1455,11,10,1
2017,1355,1455,16,10,6
2017,1371,1455,9,10,-1
2017,1374,1455,6,10,-4
2017,1376,1455,7,10,-3
2017,1388,1455,7,10,-3
2017,1407,1455,15,10,5
2017,1411,1455,16,10,6
2017,1413,1455,16,10,6
2017,1417,1455,3,10,-7
2017,1423,1455,12,10,2
2017,1425,1455,11,10,1
2017,1433,1455,10,10,0
2017,1435,1455,9,10,-1
2017,1436,1455,13,10,3
2017,1437,1455,1,10,-9
2017,1438,1455,5,10,-5
2017,1439,1455,9,10,-1
2017,1448,1455,11,10,1
2017,1452,1455,4,10,-6
2017,1112,1457,2,13,-11
2017,1116,1457,8,13,-5
2017,1124,1457,3,13,-10
2017,1137,1457,13,13,0
2017,1139,1457,4,13,-9
2017,1153,1457,6,13,-7
2017,1166,1457,6,13,-7
2017,1173,1457,7,13,-6
2017,1181,1457,2,13,-11
2017,1190,1457,13,13,0
2017,1195,1457,14,13,1
2017,1196,1457,4,13,-9
2017,1199,1457,3,13,-10
2017,1211,1457,1,13,-12
2017,1233,1457,14,13,1
2017,1235,1457,5,13,-8
2017,1240,1457,15,13,2
2017,1242,1457,1,13,-12
2017,1243,1457,11,13,-2
2017,1245,1457,14,13,1
2017,1246,1457,2,13,-11
2017,1257,1457,2,13,-11
2017,1266,1457,10,13,-3
2017,1268,1457,6,13,-7
2017,1274,1457,8,13,-5
2017,1276,1457,7,13,-6
2017,1277,1457,9,13,-4
2017,1278,1457,5,13,-8
2017,1291,1457,16,13,3
2017,1292,1457,12,13,-1
2017,1297,1457,15,13,2
2017,1300,1457,16,13,3
2017,1305,1457,12,13,-1
2017,1308,1457,14,13,1
2017,1309,1457,16,13,3
2017,1314,1457,1,13,-12
2017,1315,1457,15,13,2
2017,1321,1457,8,13,-5
2017,1323,1457,5,13,-8
2017,1329,1457,10,13,-3
2017,1332,1457,3,13,-10
2017,1343,1457,12,13,-1
2017,1344,1457,11,13,-2
2017,1345,1457,4,13,-9
2017,1348,1457,11,13,-2
2017,1355,1457,16,13,3
2017,1371,1457,9,13,-4
2017,1374,1457,6,13,-7
2017,1376,1457,7,13,-6
2017,1388,1457,7,13,-6
2017,1407,1457,15,13,2
2017,1411,1457,16,13,3
2017,1413,1457,16,13,3
2017,1417,1457,3,13,-10
2017,1423,1457,12,13,-1
2017,1425,1457,11,13,-2
2017,1433,1457,10,13,-3
2017,1435,1457,9,13,-4
2017,1436,1457,13,13,0
2017,1437,1457,1,13,-12
2017,1438,1457,5,13,-8
2017,1439,1457,9,13,-4
2017,1448,1457,11,13,-2
2017,1452,1457,4,13,-9
2017,1455,1457,10,13,-3
2017,1112,1458,2,8,-6
2017,1116,1458,8,8,0
2017,1124,1458,3,8,-5
2017,1137,1458,13,8,5
2017,1139,1458,4,8,-4
2017,1153,1458,6,8,-2
2017,1166,1458,6,8,-2
2017,1173,1458,7,8,-1
2017,1181,1458,2,8,-6
2017,1190,1458,13,8,5
2017,1195,1458,14,8,6
2017,1196,1458,4,8,-4
2017,1199,1458,3,8,-5
2017,1211,1458,1,8,-7
2017,1233,1458,14,8,6
2017,1235,1458,5,8,-3
2017,1240,1458,15,8,7
2017,1242,1458,1,8,-7
2017,1243,1458,11,8,3
2017,1245,1458,14,8,6
2017,1246,1458,2,8,-6
2017,1257,1458,2,8,-6
2017,1266,1458,10,8,2
2017,1268,1458,6,8,-2
2017,1274,1458,8,8,0
2017,1276,1458,7,8,-1
2017,1277,1458,9,8,1
2017,1278,1458,5,8,-3
2017,1291,1458,16,8,8
2017,1292,1458,12,8,4
2017,1297,1458,15,8,7
2017,1300,1458,16,8,8
2017,1305,1458,12,8,4
2017,1308,1458,14,8,6
2017,1309,1458,16,8,8
2017,1314,1458,1,8,-7
2017,1315,1458,15,8,7
2017,1321,1458,8,8,0
2017,1323,1458,5,8,-3
2017,1329,1458,10,8,2
2017,1332,1458,3,8,-5
2017,1343,1458,12,8,4
2017,1344,1458,11,8,3
2017,1345,1458,4,8,-4
2017,1348,1458,11,8,3
2017,1355,1458,16,8,8
2017,1371,1458,9,8,1
2017,1374,1458,6,8,-2
2017,1376,1458,7,8,-1
2017,1388,1458,7,8,-1
2017,1407,1458,15,8,7
2017,1411,1458,16,8,8
2017,1413,1458,16,8,8
2017,1417,1458,3,8,-5
2017,1423,1458,12,8,4
2017,1425,1458,11,8,3
2017,1433,1458,10,8,2
2017,1435,1458,9,8,1
2017,1436,1458,13,8,5
2017,1437,1458,1,8,-7
2017,1438,1458,5,8,-3
2017,1439,1458,9,8,1
2017,1448,1458,11,8,3
2017,1452,1458,4,8,-4
2017,1455,1458,10,8,2
2017,1457,1458,13,8,5
2017,1112,1462,2,11,-9
2017,1116,1462,8,11,-3
2017,1124,1462,3,11,-8
2017,1137,1462,13,11,2
2017,1139,1462,4,11,-7
2017,1153,1462,6,11,-5
2017,1166,1462,6,11,-5
2017,1173,1462,7,11,-4
2017,1181,1462,2,11,-9
2017,1190,1462,13,11,2
2017,1195,1462,14,11,3
2017,1196,1462,4,11,-7
2017,1199,1462,3,11,-8
2017,1211,1462,1,11,-10
2017,1233,1462,14,11,3
2017,1235,1462,5,11,-6
2017,1240,1462,15,11,4
2017,1242,1462,1,11,-10
2017,1243,1462,11,11,0
2017,1245,1462,14,11,3
2017,1246,1462,2,11,-9
2017,1257,1462,2,11,-9
2017,1266,1462,10,11,-1
2017,1268,1462,6,11,-5
2017,1274,1462,8,11,-3
2017,1276,1462,7,11,-4
2017,1277,1462,9,11,-2
2017,1278,1462,5,11,-6
2017,1291,1462,16,11,5
2017,1292,1462,12,11,1
2017,1297,1462,15,11,4
2017,1300,1462,16,11,5
2017,1305,1462,12,11,1
2017,1308,1462,14,11,3
2017,1309,1462,16,11,5
2017,1314,1462,1,11,-10
2017,1315,1462,15,11,4
2017,1321,1462,8,11,-3
2017,1323,1462,5,11,-6
2017,1329,1462,10,11,-1
2017,1332,1462,3,11,-8
2017,1343,1462,12,11,1
2017,1344,1462,11,11,0
2017,1345,1462,4,11,-7
2017,1348,1462,11,11,0
2017,1355,1462,16,11,5
2017,1371,1462,9,11,-2
2017,1374,1462,6,11,-5
2017,1376,1462,7,11,-4
2017,1388,1462,7,11,-4
2017,1407,1462,15,11,4
2017,1411,1462,16,11,5
2017,1413,1462,16,11,5
2017,1417,1462,3,11,-8
2017,1423,1462,12,11,1
2017,1425,1462,11,11,0
2017,1433,1462,10,11,-1
2017,1435,1462,9,11,-2
2017,1436,1462,13,11,2
2017,1437,1462,1,11,-10
2017,1438,1462,5,11,-6
2017,1439,1462,9,11,-2
2017,1448,1462,11,11,0
2017,1452,1462,4,11,-7
2017,1455,1462,10,11,-1
2017,1457,1462,13,11,2
2017,1458,1462,8,11,-3
2018,1104,1112,9,4,5
2018,1104,1113,9,11,-2
2018,1112,1113,4,11,-7
2018,1104,1116,9,7,2
2018,1112,1116,4,7,-3
2018,1113,1116,11,7,4
2018,1104,1120,9,4,5
2018,1112,1120,4,4,0
2018,1113,1120,11,4,7
2018,1116,1120,7,4,3
2018,1104,1137,9,14,-5
2018,1112,1137,4,14,-10
2018,1113,1137,11,14,-3
2018,1116,1137,7,14,-7
2018,1120,1137,4,14,-10
2018,1104,1138,9,13,-4
2018,1112,1138,4,13,-9
2018,1113,1138,11,13,-2
2018,1116,1138,7,13,-6
2018,1120,1138,4,13,-9
2018,1137,1138,14,13,1
2018,1104,1139,9,10,-1
2018,1112,1139,4,10,-6
2018,1113,1139,11,10,1
2018,1116,1139,7,10,-3
2018,1120,1139,4,10,-6
2018,1137,1139,14,10,4
2018,1138,1139,13,10,3
2018,1104,1153,9,2,7
2018,1112,1153,4,2,2
2018,1113,1153,11,2,9
2018,1116,1153,7,2,5
2018,1120,1153,4,2,2
2018,1137,1153,14,2,12
2018,1138,1153,13,2,11
2018,1139,1153,10,2,8
2018,1104,1155,9,5,4
2018,1112,1155,4,5,-1
2018,1113,1155,11,5,6
2018,1116,1155,7,5,2
2018,1120,1155,4,5,-1
2018,1137,1155,14,5,9
2018,1138,1155,13,5,8
2018,1139,1155,10,5,5
2018,1153,1155,2,5,-3
2018,1104,1158,9,13,-4
2018,1112,1158,4,13,-9
2018,1113,1158,11,13,-2
2018,1116,1158,7,13,-6
2018,1120,1158,4,13,-9
2018,1137,1158,14,13,1
2018,1138,1158,13,13,0
2018,1139,1158,10,13,-3
2018,1153,1158,2,13,-11
2018,1155,1158,5,13,-8
2018,1104,1166,9,8,1
2018,1112,1166,4,8,-4
2018,1113,1166,11,8,3
2018,1116,1166,7,8,-1
2018,1120,1166,4,8,-4
2018,1137,1166,14,8,6
2018,1138,1166,13,8,5
2018,1139,1166,10,8,2
2018,1153,1166,2,8,-6
2018,1155,1166,5,8,-3
2018,1158,1166,13,8,5
2018,1104,1168,9,15,-6
2018,1112,1168,4,15,-11
2018,1113,1168,11,15,-4
2018,1116,1168,7,15,-8
2018,1120,1168,4,15,-11
2018,1137,1168,14,15,-1
2018,1138,1168,13,15,-2
2018,1139,1168,10,15,-5
2018,1153,1168,2,15,-13
2018,1155,1168,5,15,-10
2018,1158,1168,13,15,-2
2018,1166,1168,8,15,-7
2018,1104,1172,9,12,-3
2018,1112,1172,4,12,-8
2018,1113,1172,11,12,-1
2018,1116,1172,7,12,-5
2018,1120,1172,4,12,-8
2018,1137,1172,14,12,2
2018,1138,1172,13,12,1
2018,1139,1172,10,12,-2
2018,1153,1172,2,12,-10
2018,1155,1172,5,12,-7
2018,1158,1172,13,12,1
2018,1166,1172,8,12,-4
2018,1168,1172,15,12,3
2018,1104,1181,9,2,7
2018,1112,1181,4,2,2
2018,1113,1181,11,2,9
2018,1116,1181,7,2,5
2018,1120,1181,4,2,2
2018,1137,1181,14,2,12
2018,1138,1181,13,2,11
2018,1139,1181,10,2,8
2018,1153,1181,2,2,0
2018,1155,1181,5,2,3
2018,1158,1181,13,2,11
2018,1166,1181,8,2,6
2018,1168,1181,15,2,13
2018,1172,1181,12,2,10
2018,1104,1196,9,6,3
2018,1112,1196,4,6,-2
2018,1113,1196,11,6,5
2018,1116,1196,7,6,1
2018,1120,1196,4,6,-2
2018,1137,1196,14,6,8
2018,1138,1196,13,6,7
2018,1139,1196,10,6,4
2018,1153,1196,2,6,-4
2018,1155,1196,5,6,-1
2018,1158,1196,13,6,7
2018,1166,1196,8,6,2
2018,1168,1196,15,6,9
2018,1172,1196,12,6,6
2018,1181,1196,2,6,-4
2018,1104,1199,9,9,0
2018,1112,1199,4,9,-5
2018,1113,1199,11,9,2
2018,1116,1199,7,9,-2
2018,1120,1199,4,9,-5
2018,1137,1199,14,9,5
2018,1138,1199,13,9,4
2018,1139,1199,10,9,1
2018,1153,1199,2,9,-7
2018,1155,1199,5,9,-4
2018,1158,1199,13,9,4
2018,1166,1199,8,9,-1
2018,1168,1199,15,9,6
2018,1172,1199,12,9,3
2018,1181,1199,2,9,-7
2018,1196,1199,6,9,-3
2018,1104,1209,9,15,-6
2018,1112,1209,4,15,-11
2018,1113,1209,11,15,-4
2018,1116,1209,7,15,-8
2018,1120,1209,4,15,-11
2018,1137,1209,14,15,-1
2018,1138,1209,13,15,-2
2018,1139,1209,10,15,-5
2018,1153,1209,2,15,-13
2018,1155,1209,5,15,-10
2018,1158,1209,13,15,-2
2018,1166,1209,8,15,-7
2018,1168,1209,15,15,0
2018,1172,1209,12,15,-3
2018,1181,1209,2,15,-13
2018,1196,1209,6,15,-9
2018,1199,1209,9,15,-6
2018,1104,1211,9,4,5
2018,1112,1211,4,4,0
2018,1113,1211,11,4,7
2018,1116,1211,7,4,3
2018,1120,1211,4,4,0
2018,1137,1211,14,4,10
2018,1138,1211,13,4,9
2018,1139,1211,10,4,6
2018,1153,1211,2,4,-2
2018,1155,1211,5,4,1
2018,1158,1211,13,4,9
2018,1166,1211,8,4,4
2018,1168,1211,15,4,11
2018,1172,1211,12,4,8
2018,1181,1211,2,4,-2
2018,1196,1211,6,4,2
2018,1199,1211,9,4,5
2018,1209,1211,15,4,11
2018,1104,1222,9,6,3
2018,1112,1222,4,6,-2
2018,1113,1222,11,6,5
2018,1116,1222,7,6,1
2018,1120,1222,4,6,-2
2018,1137,1222,14,6,8
2018,1138,1222,13,6,7
2018,1139,1222,10,6,4
2018,1153,1222,2,6,-4
2018,1155,1222,5,6,-1
2018,1158,1222,13,6,7
2018,1166,1222,8,6,2
2018,1168,1222,15,6,9
2018,1172,1222,12,6,6
2018,1181,1222,2,6,-4
2018,1196,1222,6,6,0
2018,1199,1222,9,6,3
2018,1209,1222,15,6,9
2018,1211,1222,4,6,-2
2018,1104,1233,9,15,-6
2018,1112,1233,4,15,-11
2018,1113,1233,11,15,-4
2018,1116,1233,7,15,-8
2018,1120,1233,4,15,-11
2018,1137,1233,14,15,-1
2018,1138,1233,13,15,-2
2018,1139,1233,10,15,-5
2018,1153,1233,2,15,-13
2018,1155,1233,5,15,-10
2018,1158,1233,13,15,-2
2018,1166,1233,8,15,-7
2018,1168,1233,15,15,0
2018,1172,1233,12,15,-3
2018,1181,1233,2,15,-13
2018,1196,1233,6,15,-9
2018,1199,1233,9,15,-6
2018,1209,1233,15,15,0
2018,1211,1233,4,15,-11
2018,1222,1233,6,15,-9
2018,1104,1242,9,1,8
2018,1112,1242,4,1,3
2018,1113,1242,11,1,10
2018,1116,1242,7,1,6
2018,1120,1242,4,1,3
2018,1137,1242,14,1,13
2018,1138,1242,13,1,12
2018,1139,1242,10,1,9
2018,1153,1242,2,1,1
2018,1155,1242,5,1,4
2018,1158,1242,13,1,12
2018,1166,1242,8,1,7
2018,1168,1242,15,1,14
2018,1172,1242,12,1,11
2018,1181,1242,2,1,1
2018,1196,1242,6,1,5
2018,1199,1242,9,1,8
2018,1209,1242,15,1,14
2018,1211,1242,4,1,3
2018,1222,1242,6,1,5
2018,1233,1242,15,1,14
2018,1104,1243,9,9,0
2018,1112,1243,4,9,-5
2018,1113,1243,11,9,2
2018,1116,1243,7,9,-2
2018,1120,1243,4,9,-5
2018,1137,1243,14,9,5
2018,1138,1243,13,9,4
2018,1139,1243,10,9,1
2018,1153,1243,2,9,-7
2018,1155,1243,5,9,-4
2018,1158,1243,13,9,4
2018,1166,1243,8,9,-1
2018,1168,1243,15,9,6
2018,1172,1243,12,9,3
2018,1181,1243,2,9,-7
2018,1196,1243,6,9,-3
2018,1199,1243,9,9,0
2018,1209,1243,15,9,6
2018,1211,1243,4,9,-5
2018,1222,1243,6,9,-3
2018,1233,1243,15,9,6
2018,1242,1243,1,9,-8
2018,1104,1246,9,5,4
2018,1112,1246,4,5,-1
2018,1113,1246,11,5,6
2018,1116,1246,7,5,2
2018,1120,1246,4,5,-1
2018,1137,1246,14,5,9
2018,1138,1246,13,5,8
2018,1139,1246,10,5,5
2018,1153,1246,2,5,-3
2018,1155,1246,5,5,0
2018,1158,1246,13,5,8
2018,1166,1246,8,5,3
2018,1168,1246,15,5,10
2018,1172,1246,12,5,7
2018,1181,1246,2,5,-3
2018,1196,1246,6,5,1
2018,1199,1246,9,5,4
2018,1209,1246,15,5,10
2018,1211,1246,4,5,-1
2018,1222,1246,6,5,1
2018,1233,1246,15,5,10
2018,1242,1246,1,5,-4
2018,1243,1246,9,5,4
2018,1104,1252,9,15,-6
2018,1112,1252,4,15,-11
2018,1113,1252,11,15,-4
2018,1116,1252,7,15,-8
2018,1120,1252,4,15,-11
2018,1137,1252,14,15,-1
2018,1138,1252,13,15,-2
2018,1139,1252,10,15,-5
2018,1153,1252,2,15,-13
2018,1155,1252,5,15,-10
2018,1158,1252,13,15,-2
2018,1166,1252,8,15,-7
2018,1168,1252,15,15,0
2018,1172,1252,12,15,-3
2018,1181,1252,2,15,-13
2018,1196,1252,6,15,-9
2018,1199,1252,9,15,-6
2018,1209,1252,15,15,0
2018,1211,1252,4,15,-11
2018,1222,1252,6,15,-9
2018,1233,1252,15,15,0
2018,1242,1252,1,15,-14
2018,1243,1252,9,15,-6
2018,1246,1252,5,15,-10
2018,1104,1254,9,16,-7
2018,1112,1254,4,16,-12
2018,1113,1254,11,16,-5
2018,1116,1254,7,16,-9
2018,1120,1254,4,16,-12
2018,1137,1254,14,16,-2
2018,1138,1254,13,16,-3
2018,1139,1254,10,16,-6
2018,1153,1254,2,16,-14
2018,1155,1254,5,16,-11
2018,1158,1254,13,16,-3
2018,1166,1254,8,16,-8
2018,1168,1254,15,16,-1
2018,1172,1254,12,16,-4
2018,1181,1254,2,16,-14
2018,1196,1254,6,16,-10
2018,1199,1254,9,16,-7
2018,1209,1254,15,16,-1
2018,1211,1254,4,16,-12
2018,1222,1254,6,16,-10
2018,1233,1254,15,16,-1
2018,1242,1254,1,16,-15
2018,1243,1254,9,16,-7
2018,1246,1254,5,16,-11
2018,1252,1254,15,16,-1
2018,1104,1260,9,11,-2
2018,1112,1260,4,11,-7
2018,1113,1260,11,11,0
2018,1116,1260,7,11,-4
2018,1120,1260,4,11,-7
2018,1137,1260,14,11,3
2018,1138,1260,13,11,2
2018,1139,1260,10,11,-1
2018,1153,1260,2,11,-9
2018,1155,1260,5,11,-6
2018,1158,1260,13,11,2
2018,1166,1260,8,11,-3
2018,1168,1260,15,11,4
2018,1172,1260,12,11,1
2018,1181,1260,2,11,-9
2018,1196,1260,6,11,-5
2018,1199,1260,9,11,-2
2018,1209,1260,15,11,4
2018,1211,1260,4,11,-7
2018,1222,1260,6,11,-5
2018,1233,1260,15,11,4
2018,1242,1260,1,11,-10
2018,1243,1260,9,11,-2
2018,1246,1260,5,11,-6
2018,1252,1260,15,11,4
2018,1254,1260,16,11,5
2018,1104,1267,9,13,-4
2018,1112,1267,4,13,-9
2018,1113,1267,11,13,-2
2018,1116,1267,7,13,-6
2018,1120,1267,4,13,-9
2018,1137,1267,14,13,1
2018,1138,1267,13,13,0
2018,1139,1267,10,13,-3
2018,1153,1267,2,13,-11
2018,1155,1267,5,13,-8
2018,1158,1267,13,13,0
2018,1166,1267,8,13,-5
2018,1168,1267,15,13,2
2018,1172,1267,12,13,-1
2018,1181,1267,2,13,-11
2018,1196,1267,6,13,-7
2018,1199,1267,9,13,-4
2018,1209,1267,15,13,2
2018,1211,1267,4,13,-9
2018,1222,1267,6,13,-7
2018,1233,1267,15,13,2
2018,1242,1267,1,13,-12
2018,1243,1267,9,13,-4
2018,1246,1267,5,13,-8
2018,1252,1267,15,13,2
2018,1254,1267,16,13,3
2018,1260,1267,11,13,-2
2018,1104,1274,9,6,3
2018,1112,1274,4,6,-2
2018,1113,1274,11,6,5
2018,1116,1274,7,6,1
2018,1120,1274,4,6,-2
2018,1137,1274,14,6,8
2018,1138,1274,13,6,7
2018,1139,1274,10,6,4
2018,1153,1274,2,6,-4
2018,1155,1274,5,6,-1
2018,1158,1274,13,6,7
2018,1166,1274,8,6,2
2018,1168,1274,15,6,9
2018,1172,1274,12,6,6
2018,1181,1274,2,6,-4
2018,1196,1274,6,6,0
2018,1199,1274,9,6,3
2018,1209,1274,15,6,9
2018,1211,1274,4,6,-2
2018,1222,1274,6,6,0
2018,1233,1274,15,6,9
2018,1242,1274,1,6,-5
2018,1243,1274,9,6,3
2018,1246,1274,5,6,-1
2018,1252,1274,15,6,9
2018,1254,1274,16,6,10
2018,1260,1274,11,6,5
2018,1267,1274,13,6,7
2018,1104,1276,9,3,6
2018,1112,1276,4,3,1
2018,1113,1276,11,3,8
2018,1116,1276,7,3,4
2018,1120,1276,4,3,1
2018,1137,1276,14,3,11
2018,1138,1276,13,3,10
2018,1139,1276,10,3,7
2018,1153,1276,2,3,-1
2018,1155,1276,5,3,2
2018,1158,1276,13,3,10
2018,1166,1276,8,3,5
2018,1168,1276,15,3,12
2018,1172,1276,12,3,9
2018,1181,1276,2,3,-1
2018,1196,1276,6,3,3
2018,1199,1276,9,3,6
2018,1209,1276,15,3,12
2018,1211,1276,4,3,1
2018,1222,1276,6,3,3
2018,1233,1276,15,3,12
2018,1242,1276,1,3,-2
2018,1243,1276,9,3,6
2018,1246,1276,5,3,2
2018,1252,1276,15,3,12
2018,1254,1276,16,3,13
2018,1260,1276,11,3,8
2018,1267,1276,13,3,10
2018,1274,1276,6,3,3
2018,1104,1277,9,3,6
2018,1112,1277,4,3,1
2018,1113,1277,11,3,8
2018,1116,1277,7,3,4
2018,1120,1277,4,3,1
2018,1137,1277,14,3,11
2018,1138,1277,13,3,10
2018,1139,1277,10,3,7
2018,1153,1277,2,3,-1
2018,1155,1277,5,3,2
2018,1158,1277,13,3,10
2018,1166,1277,8,3,5
2018,1168,1277,15,3,12
2018,1172,1277,12,3,9
2018,1181,1277,2,3,-1
2018,1196,1277,6,3,3
2018,1199,1277,9,3,6
2018,1209,1277,15,3,12
2018,1211,1277,4,3,1
2018,1222,1277,6,3,3
2018,1233,1277,15,3,12
2018,1242,1277,1,3,-2
2018,1243,1277,9,3,6
2018,1246,1277,5,3,2
2018,1252,1277,15,3,12
2018,1254,1277,16,3,13
2018,1260,1277,11,3,8
2018,1267,1277,13,3,10
2018,1274,1277,6,3,3
2018,1276,1277,3,3,0
2018,1104,1281,9,8,1
2018,1112,1281,4,8,-4
2018,1113,1281,11,8,3
2018,1116,1281,7,8,-1
2018,1120,1281,4,8,-4
2018,1137,1281,14,8,6
2018,1138,1281,13,8,5
2018,1139,1281,10,8,2
2018,1153,1281,2,8,-6
2018,1155,1281,5,8,-3
2018,1158,1281,13,8,5
2018,1166,1281,8,8,0
2018,1168,1281,15,8,7
2018,1172,1281,12,8,4
2018,1181,1281,2,8,-6
2018,1196,1281,6,8,-2
2018,1199,1281,9,8,1
2018,1209,1281,15,8,7
2018,1211,1281,4,8,-4
2018,1222,1281,6,8,-2
2018,1233,1281,15,8,7
2018,1242,1281,1,8,-7
2018,1243,1281,9,8,1
2018,1246,1281,5,8,-3
2018,1252,1281,15,8,7
2018,1254,1281,16,8,8
2018,1260,1281,11,8,3
2018,1267,1281,13,8,5
2018,1274,1281,6,8,-2
2018,1276,1281,3,8,-5
2018,1277,1281,3,8,-5
2018,1104,1285,9,14,-5
2018,1112,1285,4,14,-10
2018,1113,1285,11,14,-3
2018,1116,1285,7,14,-7
2018,1120,1285,4,14,-10
2018,1137,1285,14,14,0
2018,1138,1285,13,14,-1
2018,1139,1285,10,14,-4
2018,1153,1285,2,14,-12
2018,1155,1285,5,14,-9
2018,1158,1285,13,14,-1
2018,1166,1285,8,14,-6
2018,1168,1285,15,14,1
2018,1172,1285,12,14,-2
2018,1181,1285,2,14,-12
2018,1196,1285,6,14,-8
2018,1199,1285,9,14,-5
2018,1209,1285,15,14,1
2018,1211,1285,4,14,-10
2018,1222,1285,6,14,-8
2018,1233,1285,15,14,1
2018,1242,1285,1,14,-13
2018,1243,1285,9,14,-5
2018,1246,1285,5,14,-9
2018,1252,1285,15,14,1
2018,1254,1285,16,14,2
2018,1260,1285,11,14,-3
2018,1267,1285,13,14,-1
2018,1274,1285,6,14,-8
2018,1276,1285,3,14,-11
2018,1277,1285,3,14,-11
2018,1281,1285,8,14,-6
2018,1104,1293,9,12,-3
2018,1112,1293,4,12,-8
2018,1113,1293,11,12,-1
2018,1116,1293,7,12,-5
2018,1120,1293,4,12,-8
2018,1137,1293,14,12,2
2018,1138,1293,13,12,1
2018,1139,1293,10,12,-2
2018,1153,1293,2,12,-10
2018,1155,1293,5,12,-7
2018,1158,1293,13,12,1
2018,1166,1293,8,12,-4
2018,1168,1293,15,12,3
2018,1172,1293,12,12,0
2018,1181,1293,2,12,-10
2018,1196,1293,6,12,-6
2018,1199,1293,9,12,-3
2018,1209,1293,15,12,3
2018,1211,1293,4,12,-8
2018,1222,1293,6,12,-6
2018,1233,1293,15,12,3
2018,1242,1293,1,12,-11
2018,1243,1293,9,12,-3
2018,1246,1293,5,12,-7
2018,1252,1293,15,12,3
2018,1254,1293,16,12,4
2018,1260,1293,11,12,-1
2018,1267,1293,13,12,1
2018,1274,1293,6,12,-6
2018,1276,1293,3,12,-9
2018,1277,1293,3,12,-9
2018,1281,1293,8,12,-4
2018,1285,1293,14,12,2
2018,1104,1300,9,16,-7
2018,1112,1300,4,16,-12
2018,1113,1300,11,16,-5
2018,1116,1300,7,16,-9
2018,1120,1300,4,16,-12
2018,1137,1300,14,16,-2
2018,1138,1300,13,16,-3
2018,1139,1300,10,16,-6
2018,1153,1300,2,16,-14
2018,1155,1300,5,16,-11
2018,1158,1300,13,16,-3
2018,1166,1300,8,16,-8
2018,1168,1300,15,16,-1
2018,1172,1300,12,16,-4
2018,1181,1300,2,16,-14
2018,1196,1300,6,16,-10
2018,1199,1300,9,16,-7
2018,1209,1300,15,16,-1
2018,1211,1300,4,16,-12
2018,1222,1300,6,16,-10
2018,1233,1300,15,16,-1
2018,1242,1300,1,16,-15
2018,1243,1300,9,16,-7
2018,1246,1300,5,16,-11
2018,1252,1300,15,16,-1
2018,1254,1300,16,16,0
2018,1260,1300,11,16,-5
2018,1267,1300,13,16,-3
2018,1274,1300,6,16,-10
2018,1276,1300,3,16,-13
2018,1277,1300,3,16,-13
2018,1281,1300,8,16,-8
2018,1285,1300,14,16,-2
2018,1293,1300,12,16,-4
2018,1104,1301,9,9,0
2018,1112,1301,4,9,-5
2018,1113,1301,11,9,2
2018,1116,1301,7,9,-2
2018,1120,1301,4,9,-5
2018,1137,1301,14,9,5
2018,1138,1301,13,9,4
2018,1139,1301,10,9,1
2018,1153,1301,2,9,-7
2018,1155,1301,5,9,-4
2018,1158,1301,13,9,4
2018,1166,1301,8,9,-1
2018,1168,1301,15,9,6
2018,1172,1301,12,9,3
2018,1181,1301,2,9,-7
2018,1196,1301,6,9,-3
2018,1199,1301,9,9,0
2018,1209,1301,15,9,6
2018,1211,1301,4,9,-5
2018,1222,1301,6,9,-3
2018,1233,1301,15,9,6
2018,1242,1301,1,9,-8
2018,1243,1301,9,9,0
2018,1246,1301,5,9,-4
2018,1252,1301,15,9,6
2018,1254,1301,16,9,7
2018,1260,1301,11,9,2
2018,1267,1301,13,9,4
2018,1274,1301,6,9,-3
2018,1276,1301,3,9,-6
2018,1277,1301,3,9,-6
2018,1281,1301,8,9,-1
2018,1285,1301,14,9,5
2018,1293,1301,12,9,3
2018,1300,1301,16,9,7
2018,1104,1305,9,7,2
2018,1112,1305,4,7,-3
2018,1113,1305,11,7,4
2018,1116,1305,7,7,0
2018,1120,1305,4,7,-3
2018,1137,1305,14,7,7
2018,1138,1305,13,7,6
2018,1139,1305,10,7,3
2018,1153,1305,2,7,-5
2018,1155,1305,5,7,-2
2018,1158,1305,13,7,6
2018,1166,1305,8,7,1
2018,1168,1305,15,7,8
2018,1172,1305,12,7,5
2018,1181,1305,2,7,-5
2018,1196,1305,6,7,-1
2018,1199,1305,9,7,2
2018,1209,1305,15,7,8
2018,1211,1305,4,7,-3
2018,1222,1305,6,7,-1
2018,1233,1305,15,7,8
2018,1242,1305,1,7,-6
2018,1243,1305,9,7,2
2018,1246,1305,5,7,-2
2018,1252,1305,15,7,8
2018,1254,1305,16,7,9
2018,1260,1305,11,7,4
2018,1267,1305,13,7,6
2018,1274,1305,6,7,-1
2018,1276,1305,3,7,-4
2018,1277,1305,3,7,-4
2018,1281,1305,8,7,1
2018,1285,1305,14,7,7
2018,1293,1305,12,7,5
2018,1300,1305,16,7,9
2018,1301,1305,9,7,2
2018,1104,1308,9,12,-3
2018,1112,1308,4,12,-8
2018,1113,1308,11,12,-1
2018,1116,1308,7,12,-5
2018,1120,1308,4,12,-8
2018,1137,1308,14,12,2
2018,1138,1308,13,12,1
2018,1139,1308,10,12,-2
2018,1153,1308,2,12,-10
2018,1155,1308,5,12,-7
2018,1158,1308,13,12,1
2018,1166,1308,8,12,-4
2018,1168,1308,15,12,3
2018,1172,1308,12,12,0
2018,1181,1308,2,12,-10
2018,1196,1308,6,12,-6
2018,1199,1308,9,12,-3
2018,1209,1308,15,12,3
2018,1211,1308,4,12,-8
2018,1222,1308,6,12,-6
2018,1233,1308,15,12,3
2018,1242,1308,1,12,-11
2018,1243,1308,9,12,-3
2018,1246,1308,5,12,-7
2018,1252,1308,15,12,3
2018,1254,1308,16,12,4
2018,1260,1308,11,12,-1
2018,1267,1308,13,12,1
2018,1274,1308,6,12,-6
2018,1276,1308,3,12,-9
2018,1277,1308,3,12,-9
2018,1281,1308,8,12,-4
2018,1285,1308,14,12,2
2018,1293,1308,12,12,0
2018,1300,1308,16,12,4
2018,1301,1308,9,12,-3
2018,1305,1308,7,12,-5
2018,1104,1314,9,2,7
2018,1112,1314,4,2,2
2018,1113,1314,11,2,9
2018,1116,1314,7,2,5
2018,1120,1314,4,2,2
2018,1137,1314,14,2,12
2018,1138,1314,13,2,11
2018,1139,1314,10,2,8
2018,1153,1314,2,2,0
2018,1155,1314,5,2,3
2018,1158,1314,13,2,11
2018,1166,1314,8,2,6
2018,1168,1314,15,2,13
2018,1172,1314,12,2,10
2018,1181,1314,2,2,0
2018,1196,1314,6,2,4
2018,1199,1314,9,2,7
2018,1209,1314,15,2,13
2018,1211,1314,4,2,2
2018,1222,1314,6,2,4
2018,1233,1314,15,2,13
2018,1242,1314,1,2,-1
2018,1243,1314,9,2,7
2018,1246,1314,5,2,3
2018,1252,1314,15,2,13
2018,1254,1314,16,2,14
2018,1260,1314,11,2,9
2018,1267,1314,13,2,11
2018,1274,1314,6,2,4
2018,1276,1314,3,2,1
2018,1277,1314,3,2,1
2018,1281,1314,8,2,6
2018,1285,1314,14,2,12
2018,1293,1314,12,2,10
2018,1300,1314,16,2,14
2018,1301,1314,9,2,7
2018,1305,1314,7,2,5
2018,1308,1314,12,2,10
2018,1104,1326,9,5,4
2018,1112,1326,4,5,-1
2018,1113,1326,11,5,6
2018,1116,1326,7,5,2
2018,1120,1326,4,5,-1
2018,1137,1326,14,5,9
2018,1138,1326,13,5,8
2018,1139,1326,10,5,5
2018,1153,1326,2,5,-3
2018,1155,1326,5,5,0
2018,1158,1326,13,5,8
2018,1166,1326,8,5,3
2018,1168,1326,15,5,10
2018,1172,1326,12,5,7
2018,1181,1326,2,5,-3
2018,1196,1326,6,5,1
2018,1199,1326,9,5,4
2018,1209,1326,15,5,10
2018,1211,1326,4,5,-1
2018,1222,1326,6,5,1
2018,1233,1326,15,5,10
2018,1242,1326,1,5,-4
2018,1243,1326,9,5,4
2018,1246,1326,5,5,0
2018,1252,1326,15,5,10
2018,1254,1326,16,5,11
2018,1260,1326,11,5,6
2018,1267,1326,13,5,8
2018,1274,1326,6,5,1
2018,1276,1326,3,5,-2
2018,1277,1326,3,5,-2
2018,1281,1326,8,5,3
2018,1285,1326,14,5,9
2018,1293,1326,12,5,7
2018,1300,1326,16,5,11
2018,1301,1326,9,5,4
2018,1305,1326,7,5,2
2018,1308,1326,12,5,7
2018,1314,1326,2,5,-3
2018,1104,1328,9,10,-1
2018,1112,1328,4,10,-6
2018,1113,1328,11,10,1
2018,1116,1328,7,10,-3
2018,1120,1328,4,10,-6
2018,1137,1328,14,10,4
2018,1138,1328,13,10,3
2018,1139,1328,10,10,0
2018,1153,1328,2,10,-8
2018,1155,1328,5,10,-5
2018,1158,1328,13,10,3
2018,1166,1328,8,10,-2
2018,1168,1328,15,10,5
2018,1172,1328,12,10,2
2018,1181,1328,2,10,-8
2018,1196,1328,6,10,-4
2018,1199,1328,9,10,-1
2018,1209,1328,15,10,5
2018,1211,1328,4,10,-6
2018,1222,1328,6,10,-4
2018,1233,1328,15,10,5
2018,1242,1328,1,10,-9
2018,1243,1328,9,10,-1
2018,1246,1328,5,10,-5
2018,1252,1328,15,10,5
2018,1254,1328,16,10,6
2018,1260,1328,11,10,1
2018,1267,1328,13,10,3
2018,1274,1328,6,10,-4
2018,1276,1328,3,10,-7
2018,1277,1328,3,10,-7
2018,1281,1328,8,10,-2
2018,1285,1328,14,10,4
2018,1293,1328,12,10,2
2018,1300,1328,16,10,6
2018,1301,1328,9,10,-1
2018,1305,1328,7,10,-3
2018,1308,1328,12,10,2
2018,1314,1328,2,10,-8
2018,1326,1328,5,10,-5
2018,1104,1335,9,16,-7
2018,1112,1335,4,16,-12
2018,1113,1335,11,16,-5
2018,1116,1335,7,16,-9
2018,1120,1335,4,16,-12
2018,1137,1335,14,16,-2
2018,1138,1335,13,16,-3
2018,1139,1335,10,16,-6
2018,1153,1335,2,16,-14
2018,1155,1335,5,16,-11
2018,1158,1335,13,16,-3
2018,1166,1335,8,16,-8
2018,1168,1335,15,16,-1
2018,1172,1335,12,16,-4
2018,1181,1335,2,16,-14
2018,1196,1335,6,16,-10
2018,1199,1335,9,16,-7
2018,1209,1335,15,16,-1
2018,1211,1335,4,16,-12
2018,1222,1335,6,16,-10
2018,1233,1335,15,16,-1
2018,1242,1335,1,16,-15
2018,1243,1335,9,16,-7
2018,1246,1335,5,16,-11
2018,1252,1335,15,16,-1
2018,1254,1335,16,16,0
2018,1260,1335,11,16,-5
2018,1267,1335,13,16,-3
2018,1274,1335,6,16,-10
2018,1276,1335,3,16,-13
2018,1277,1335,3,16,-13
2018,1281,1335,8,16,-8
2018,1285,1335,14,16,-2
2018,1293,1335,12,16,-4
2018,1300,1335,16,16,0
2018,1301,1335,9,16,-7
2018,1305,1335,7,16,-9
2018,1308,1335,12,16,-4
2018,1314,1335,2,16,-14
2018,1326,1335,5,16,-11
2018,1328,1335,10,16,-6
2018,1104,1344,9,10,-1
2018,1112,1344,4,10,-6
2018,1113,1344,11,10,1
2018,1116,1344,7,10,-3
2018,1120,1344,4,10,-6
2018,1137,1344,14,10,4
2018,1138,1344,13,10,3
2018,1139,1344,10,10,0
2018,1153,1344,2,10,-8
2018,1155,1344,5,10,-5
2018,1158,1344,13,10,3
2018,1166,1344,8,10,-2
2018,1168,1344,15,10,5
2018,1172,1344,12,10,2
2018,1181,1344,2,10,-8
2018,1196,1344,6,10,-4
2018,1199,1344,9,10,-1
2018,1209,1344,15,10,5
2018,1211,1344,4,10,-6
2018,1222,1344,6,10,-4
2018,1233,1344,15,10,5
2018,1242,1344,1,10,-9
2018,1243,1344,9,10,-1
2018,1246,1344,5,10,-5
2018,1252,1344,15,10,5
2018,1254,1344,16,10,6
2018,1260,1344,11,10,1
2018,1267,1344,13,10,3
2018,1274,1344,6,10,-4
2018,1276,1344,3,10,-7
2018,1277,1344,3,10,-7
2018,1281,1344,8,10,-2
2018,1285,1344,14,10,4
2018,1293,1344,12,10,2
2018,1300,1344,16,10,6
2018,1301,1344,9,10,-1
2018,1305,1344,7,10,-3
2018,1308,1344,12,10,2
2018,1314,1344,2,10,-8
2018,1326,1344,5,10,-5
2018,1328,1344,10,10,0
2018,1335,1344,16,10,6
2018,1104,1345,9,2,7
2018,1112,1345,4,2,2
2018,1113,1345,11,2,9
2018,1116,1345,7,2,5
2018,1120,1345,4,2,2
2018,1137,1345,14,2,12
2018,1138,1345,13,2,11
2018,1139,1345,10,2,8
2018,1153,1345,2,2,0
2018,1155,1345,5,2,3
2018,1158,1345,13,2,11
2018,1166,1345,8,2,6
2018,1168,1345,15,2,13
2018,1172,1345,12,2,10
2018,1181,1345,2,2,0
2018,1196,1345,6,2,4
2018,1199,1345,9,2,7
2018,1209,1345,15,2,13
2018,1211,1345,4,2,2
2018,1222,1345,6,2,4
2018,1233,1345,15,2,13
2018,1242,1345,1,2,-1
2018,1243,1345,9,2,7
2018,1246,1345,5,2,3
2018,1252,1345,15,2,13
2018,1254,1345,16,2,14
2018,1260,1345,11,2,9
2018,1267,1345,13,2,11
2018,1274,1345,6,2,4
2018,1276,1345,3,2,1
2018,1277,1345,3,2,1
2018,1281,1345,8,2,6
2018,1285,1345,14,2,12
2018,1293,1345,12,2,10
2018,1300,1345,16,2,14
2018,1301,1345,9,2,7
2018,1305,1345,7,2,5
2018,1308,1345,12,2,10
2018,1314,1345,2,2,0
2018,1326,1345,5,2,3
2018,1328,1345,10,2,8
2018,1335,1345,16,2,14
2018,1344,1345,10,2,8
2018,1104,1347,9,16,-7
2018,1112,1347,4,16,-12
2018,1113,1347,11,16,-5
2018,1116,1347,7,16,-9
2018,1120,1347,4,16,-12
2018,1137,1347,14,16,-2
2018,1138,1347,13,16,-3
2018,1139,1347,10,16,-6
2018,1153,1347,2,16,-14
2018,1155,1347,5,16,-11
2018,1158,1347,13,16,-3
2018,1166,1347,8,16,-8
2018,1168,1347,15,16,-1
2018,1172,1347,12,16,-4
2018,1181,1347,2,16,-14
2018,1196,1347,6,16,-10
2018,1199,1347,9,16,-7
2018,1209,1347,15,16,-1
2018,1211,1347,4,16,-12
2018,1222,1347,6,16,-10
2018,1233,1347,15,16,-1
2018,1242,1347,1,16,-15
2018,1243,1347,9,16,-7
2018,1246,1347,5,16,-11
2018,1252,1347,15,16,-1
2018,1254,1347,16,16,0
2018,1260,1347,11,16,-5
2018,1267,1347,13,16,-3
2018,1274,1347,6,16,-10
2018,1276,1347,3,16,-13
2018,1277,1347,3,16,-13
2018,1281,1347,8,16,-8
2018,1285,1347,14,16,-2
2018,1293,1347,12,16,-4
2018,1300,1347,16,16,0
2018,1301,1347,9,16,-7
2018,1305,1347,7,16,-9
2018,1308,1347,12,16,-4
2018,1314,1347,2,16,-14
2018,1326,1347,5,16,-11
2018,1328,1347,10,16,-6
2018,1335,1347,16,16,0
2018,1344,1347,10,16,-6
2018,1345,1347,2,16,-14
2018,1104,1348,9,7,2
2018,1112,1348,4,7,-3
2018,1113,1348,11,7,4
2018,1116,1348,7,7,0
2018,1120,1348,4,7,-3
2018,1137,1348,14,7,7
2018,1138,1348,13,7,6
2018,1139,1348,10,7,3
2018,1153,1348,2,7,-5
2018,1155,1348,5,7,-2
2018,1158,1348,13,7,6
2018,1166,1348,8,7,1
2018,1168,1348,15,7,8
2018,1172,1348,12,7,5
2018,1181,1348,2,7,-5
2018,1196,1348,6,7,-1
2018,1199,1348,9,7,2
2018,1209,1348,15,7,8
2018,1211,1348,4,7,-3
2018,1222,1348,6,7,-1
2018,1233,1348,15,7,8
2018,1242,1348,1,7,-6
2018,1243,1348,9,7,2
2018,1246,1348,5,7,-2
2018,1252,1348,15,7,8
2018,1254,1348,16,7,9
2018,1260,1348,11,7,4
2018,1267,1348,13,7,6
2018,1274,1348,6,7,-1
2018,1276,1348,3,7,-4
2018,1277,1348,3,7,-4
2018,1281,1348,8,7,1
2018,1285,1348,14,7,7
2018,1293,1348,12,7,5
2018,1300,1348,16,7,9
2018,1301,1348,9,7,2
2018,1305,1348,7,7,0
2018,1308,1348,12,7,5
2018,1314,1348,2,7,-5
2018,1326,1348,5,7,-2
2018,1328,1348,10,7,3
2018,1335,1348,16,7,9
2018,1344,1348,10,7,3
2018,1345,1348,2,7,-5
2018,1347,1348,16,7,9
2018,1104,1355,9,12,-3
2018,1112,1355,4,12,-8
2018,1113,1355,11,12,-1
2018,1116,1355,7,12,-5
2018,1120,1355,4,12,-8
2018,1137,1355,14,12,2
2018,1138,1355,13,12,1
2018,1139,1355,10,12,-2
2018,1153,1355,2,12,-10
2018,1155,1355,5,12,-7
2018,1158,1355,13,12,1
2018,1166,1355,8,12,-4
2018,1168,1355,15,12,3
2018,1172,1355,12,12,0
2018,1181,1355,2,12,-10
2018,1196,1355,6,12,-6
2018,1199,1355,9,12,-3
2018,1209,1355,15,12,3
2018,1211,1355,4,12,-8
2018,1222,1355,6,12,-6
2018,1233,1355,15,12,3
2018,1242,1355,1,12,-11
2018,1243,1355,9,12,-3
2018,1246,1355,5,12,-7
2018,1252,1355,15,12,3
2018,1254,1355,16,12,4
2018,1260,1355,11,12,-1
2018,1267,1355,13,12,1
2018,1274,1355,6,12,-6
2018,1276,1355,3,12,-9
2018,1277,1355,3,12,-9
2018,1281,1355,8,12,-4
2018,1285,1355,14,12,2
2018,1293,1355,12,12,0
2018,1300,1355,16,12,4
2018,1301,1355,9,12,-3
2018,1305,1355,7,12,-5
2018,1308,1355,12,12,0
2018,1314,1355,2,12,-10
2018,1326,1355,5,12,-7
2018,1328,1355,10,12,-2
2018,1335,1355,16,12,4
2018,1344,1355,10,12,-2
2018,1345,1355,2,12,-10
2018,1347,1355,16,12,4
2018,1348,1355,7,12,-5
2018,1104,1361,9,11,-2
2018,1112,1361,4,11,-7
2018,1113,1361,11,11,0
2018,1116,1361,7,11,-4
2018,1120,1361,4,11,-7
2018,1137,1361,14,11,3
2018,1138,1361,13,11,2
2018,1139,1361,10,11,-1
2018,1153,1361,2,11,-9
2018,1155,1361,5,11,-6
2018,1158,1361,13,11,2
2018,1166,1361,8,11,-3
2018,1168,1361,15,11,4
2018,1172,1361,12,11,1
2018,1181,1361,2,11,-9
2018,1196,1361,6,11,-5
2018,1199,1361,9,11,-2
2018,1209,1361,15,11,4
2018,1211,1361,4,11,-7
2018,1222,1361,6,11,-5
2018,1233,1361,15,11,4
2018,1242,1361,1,11,-10
2018,1243,1361,9,11,-2
2018,1246,1361,5,11,-6
2018,1252,1361,15,11,4
2018,1254,1361,16,11,5
2018,1260,1361,11,11,0
2018,1267,1361,13,11,2
2018,1274,1361,6,11,-5
2018,1276,1361,3,11,-8
2018,1277,1361,3,11,-8
2018,1281,1361,8,11,-3
2018,1285,1361,14,11,3
2018,1293,1361,12,11,1
2018,1300,1361,16,11,5
2018,1301,1361,9,11,-2
2018,1305,1361,7,11,-4
2018,1308,1361,12,11,1
2018,1314,1361,2,11,-9
2018,1326,1361,5,11,-6
2018,1328,1361,10,11,-1
2018,1335,1361,16,11,5
2018,1344,1361,10,11,-1
2018,1345,1361,2,11,-9
2018,1347,1361,16,11,5
2018,1348,1361,7,11,-4
2018,1355,1361,12,11,1
2018,1104,1371,9,8,1
2018,1112,1371,4,8,-4
2018,1113,1371,11,8,3
2018,1116,1371,7,8,-1
2018,1120,1371,4,8,-4
2018,1137,1371,14,8,6
2018,1138,1371,13,8,5
2018,1139,1371,10,8,2
2018,1153,1371,2,8,-6
2018,1155,1371,5,8,-3
2018,1158,1371,13,8,5
2018,1166,1371,8,8,0
2018,1168,1371,15,8,7
2018,1172,1371,12,8,4
2018,1181,1371,2,8,-6
2018,1196,1371,6,8,-2
2018,1199,1371,9,8,1
2018,1209,1371,15,8,7
2018,1211,1371,4,8,-4
2018,1222,1371,6,8,-2
2018,1233,1371,15,8,7
2018,1242,1371,1,8,-7
2018,1243,1371,9,8,1
2018,1246,1371,5,8,-3
2018,1252,1371,15,8,7
2018,1254,1371,16,8,8
2018,1260,1371,11,8,3
2018,1267,1371,13,8,5
2018,1274,1371,6,8,-2
2018,1276,1371,3,8,-5
2018,1277,1371,3,8,-5
2018,1281,1371,8,8,0
2018,1285,1371,14,8,6
2018,1293,1371,12,8,4
2018,1300,1371,16,8,8
2018,1301,1371,9,8,1
2018,1305,1371,7,8,-1
2018,1308,1371,12,8,4
2018,1314,1371,2,8,-6
2018,1326,1371,5,8,-3
2018,1328,1371,10,8,2
2018,1335,1371,16,8,8
2018,1344,1371,10,8,2
2018,1345,1371,2,8,-6
2018,1347,1371,16,8,8
2018,1348,1371,7,8,-1
2018,1355,1371,12,8,4
2018,1361,1371,11,8,3
2018,1104,1372,9,14,-5
2018,1112,1372,4,14,-10
2018,1113,1372,11,14,-3
2018,1116,1372,7,14,-7
2018,1120,1372,4,14,-10
2018,1137,1372,14,14,0
2018,1138,1372,13,14,-1
2018,1139,1372,10,14,-4
2018,1153,1372,2,14,-12
2018,1155,1372,5,14,-9
2018,1158,1372,13,14,-1
2018,1166,1372,8,14,-6
2018,1168,1372,15,14,1
2018,1172,1372,12,14,-2
2018,1181,1372,2,14,-12
2018,1196,1372,6,14,-8
2018,1199,1372,9,14,-5
2018,1209,1372,15,14,1
2018,1211,1372,4,14,-10
2018,1222,1372,6,14,-8
2018,1233,1372,15,14,1
2018,1242,1372,1,14,-13
2018,1243,1372,9,14,-5
2018,1246,1372,5,14,-9
2018,1252,1372,15,14,1
2018,1254,1372,16,14,2
2018,1260,1372,11,14,-3
2018,1267,1372,13,14,-1
2018,1274,1372,6,14,-8
2018,1276,1372,3,14,-11
2018,1277,1372,3,14,-11
2018,1281,1372,8,14,-6
2018,1285,1372,14,14,0
2018,1293,1372,12,14,-2
2018,1300,1372,16,14,2
2018,1301,1372,9,14,-5
2018,1305,1372,7,14,-7
2018,1308,1372,12,14,-2
2018,1314,1372,2,14,-12
2018,1326,1372,5,14,-9
2018,1328,1372,10,14,-4
2018,1335,1372,16,14,2
2018,1344,1372,10,14,-4
2018,1345,1372,2,14,-12
2018,1347,1372,16,14,2
2018,1348,1372,7,14,-7
2018,1355,1372,12,14,-2
2018,1361,1372,11,14,-3
2018,1371,1372,8,14,-6
2018,1104,1382,9,11,-2
2018,1112,1382,4,11,-7
2018,1113,1382,11,11,0
2018,1116,1382,7,11,-4
2018,1120,1382,4,11,-7
2018,1137,1382,14,11,3
2018,1138,1382,13,11,2
2018,1139,1382,10,11,-1
2018,1153,1382,2,11,-9
2018,1155,1382,5,11,-6
2018,1158,1382,13,11,2
2018,1166,1382,8,11,-3
2018,1168,1382,15,11,4
2018,1172,1382,12,11,1
2018,1181,1382,2,11,-9
2018,1196,1382,6,11,-5
2018,1199,1382,9,11,-2
2018,1209,1382,15,11,4
2018,1211,1382,4,11,-7
2018,1222,1382,6,11,-5
2018,1233,1382,15,11,4
2018,1242,1382,1,11,-10
2018,1243,1382,9,11,-2
2018,1246,1382,5,11,-6
2018,1252,1382,15,11,4
2018,1254,1382,16,11,5
2018,1260,1382,11,11,0
2018,1267,1382,13,11,2
2018,1274,1382,6,11,-5
2018,1276,1382,3,11,-8
2018,1277,1382,3,11,-8
2018,1281,1382,8,11,-3
2018,1285,1382,14,11,3
2018,1293,1382,12,11,1
2018,1300,1382,16,11,5
2018,1301,1382,9,11,-2
2018,1305,1382,7,11,-4
2018,1308,1382,12,11,1
2018,1314,1382,2,11,-9
2018,1326,1382,5,11,-6
2018,1328,1382,10,11,-1
2018,1335,1382,16,11,5
2018,1344,1382,10,11,-1
2018,1345,1382,2,11,-9
2018,1347,1382,16,11,5
2018,1348,1382,7,11,-4
2018,1355,1382,12,11,1
2018,1361,1382,11,11,0
2018,1371,1382,8,11,-3
2018,1372,1382,14,11,3
2018,1104,1393,9,11,-2
2018,1112,1393,4,11,-7
2018,1113,1393,11,11,0
2018,1116,1393,7,11,-4
2018,1120,1393,4,11,-7
2018,1137,1393,14,11,3
2018,1138,1393,13,11,2
2018,1139,1393,10,11,-1
2018,1153,1393,2,11,-9
2018,1155,1393,5,11,-6
2018,1158,1393,13,11,2
2018,1166,1393,8,11,-3
2018,1168,1393,15,11,4
2018,1172,1393,12,11,1
2018,1181,1393,2,11,-9
2018,1196,1393,6,11,-5
2018,1199,1393,9,11,-2
2018,1209,1393,15,11,4
2018,1211,1393,4,11,-7
2018,1222,1393,6,11,-5
2018,1233,1393,15,11,4
2018,1242,1393,1,11,-10
2018,1243,1393,9,11,-2
2018,1246,1393,5,11,-6
2018,1252,1393,15,11,4
2018,1254,1393,16,11,5
2018,1260,1393,11,11,0
2018,1267,1393,13,11,2
2018,1274,1393,6,11,-5
2018,1276,1393,3,11,-8
2018,1277,1393,3,11,-8
2018,1281,1393,8,11,-3
2018,1285,1393,14,11,3
2018,1293,1393,12,11,1
2018,1300,1393,16,11,5
2018,1301,1393,9,11,-2
2018,1305,1393,7,11,-4
2018,1308,1393,12,11,1
2018,1314,1393,2,11,-9
2018,1326,1393,5,11,-6
2018,1328,1393,10,11,-1
2018,1335,1393,16,11,5
2018,1344,1393,10,11,-1
2018,1345,1393,2,11,-9
2018,1347,1393,16,11,5
2018,1348,1393,7,11,-4
2018,1355,1393,12,11,1
2018,1361,1393,11,11,0
2018,1371,1393,8,11,-3
2018,1372,1393,14,11,3
2018,1382,1393,11,11,0
2018,1104,1395,9,6,3
2018,1112,1395,4,6,-2
2018,1113,1395,11,6,5
2018,1116,1395,7,6,1
2018,1120,1395,4,6,-2
2018,1137,1395,14,6,8
2018,1138,1395,13,6,7
2018,1139,1395,10,6,4
2018,1153,1395,2,6,-4
2018,1155,1395,5,6,-1
2018,1158,1395,13,6,7
2018,1166,1395,8,6,2
2018,1168,1395,15,6,9
2018,1172,1395,12,6,6
2018,1181,1395,2,6,-4
2018,1196,1395,6,6,0
2018,1199,1395,9,6,3
2018,1209,1395,15,6,9
2018,1211,1395,4,6,-2
2018,1222,1395,6,6,0
2018,1233,1395,15,6,9
2018,1242,1395,1,6,-5
2018,1243,1395,9,6,3
2018,1246,1395,5,6,-1
2018,1252,1395,15,6,9
2018,1254,1395,16,6,10
2018,1260,1395,11,6,5
2018,1267,1395,13,6,7
2018,1274,1395,6,6,0
2018,1276,1395,3,6,-3
2018,1277,1395,3,6,-3
2018,1281,1395,8,6,2
2018,1285,1395,14,6,8
2018,1293,1395,12,6,6
2018,1300,1395,16,6,10
2018,1301,1395,9,6,3
2018,1305,1395,7,6,1
2018,1308,1395,12,6,6
2018,1314,1395,2,6,-4
2018,1326,1395,5,6,-1
2018,1328,1395,10,6,4
2018,1335,1395,16,6,10
2018,1344,1395,10,6,4
2018,1345,1395,2,6,-4
2018,1347,1395,16,6,10
2018,1348,1395,7,6,1
2018,1355,1395,12,6,6
2018,1361,1395,11,6,5
2018,1371,1395,8,6,2
2018,1372,1395,14,6,8
2018,1382,1395,11,6,5
2018,1393,1395,11,6,5
2018,1104,1397,9,3,6
2018,1112,1397,4,3,1
2018,1113,1397,11,3,8
2018,1116,1397,7,3,4
2018,1120,1397,4,3,1
2018,1137,1397,14,3,11
2018,1138,1397,13,3,10
2018,1139,1397,10,3,7
2018,1153,1397,2,3,-1
2018,1155,1397,5,3,2
2018,1158,1397,13,3,10
2018,1166,1397,8,3,5
2018,1168,1397,15,3,12
2018,1172,1397,12,3,9
2018,1181,1397,2,3,-1
2018,1196,1397,6,3,3
2018,1199,1397,9,3,6
2018,1209,1397,15,3,12
2018,1211,1397,4,3,1
2018,1222,1397,6,3,3
2018,1233,1397,15,3,12
2018,1242,1397,1,3,-2
2018,1243,1397,9,3,6
2018,1246,1397,5,3,2
2018,1252,1397,15,3,12
2018,1254,1397,16,3,13
2018,1260,1397,11,3,8
2018,1267,1397,13,3,10
2018,1274,1397,6,3,3
2018,1276,1397,3,3,0
2018,1277,1397,3,3,0
2018,1281,1397,8,3,5
2018,1285,1397,14,3,11
2018,1293,1397,12,3,9
2018,1300,1397,16,3,13
2018,1301,1397,9,3,6
2018,1305,1397,7,3,4
2018,1308,1397,12,3,9
2018,1314,1397,2,3,-1
2018,1326,1397,5,3,2
2018,1328,1397,10,3,7
2018,1335,1397,16,3,13
2018,1344,1397,10,3,7
2018,1345,1397,2,3,-1
2018,1347,1397,16,3,13
2018,1348,1397,7,3,4
2018,1355,1397,12,3,9
2018,1361,1397,11,3,8
2018,1371,1397,8,3,5
2018,1372,1397,14,3,11
2018,1382,1397,11,3,8
2018,1393,1397,11,3,8
2018,1395,1397,6,3,3
2018,1104,1400,9,10,-1
2018,1112,1400,4,10,-6
2018,1113,1400,11,10,1
2018,1116,1400,7,10,-3
2018,1120,1400,4,10,-6
2018,1137,1400,14,10,4
2018,1138,1400,13,10,3
2018,1139,1400,10,10,0
2018,1153,1400,2,10,-8
2018,1155,1400,5,10,-5
2018,1158,1400,13,10,3
2018,1166,1400,8,10,-2
2018,1168,1400,15,10,5
2018,1172,1400,12,10,2
2018,1181,1400,2,10,-8
2018,1196,1400,6,10,-4
2018,1199,1400,9,10,-1
2018,1209,1400,15,10,5
2018,1211,1400,4,10,-6
2018,1222,1400,6,10,-4
2018,1233,1400,15,10,5
2018,1242,1400,1,10,-9
2018,1243,1400,9,10,-1
2018,1246,1400,5,10,-5
2018,1252,1400,15,10,5
2018,1254,1400,16,10,6
2018,1260,1400,11,10,1
2018,1267,1400,13,10,3
2018,1274,1400,6,10,-4
2018,1276,1400,3,10,-7
2018,1277,1400,3,10,-7
2018,1281,1400,8,10,-2
2018,1285,1400,14,10,4
2018,1293,1400,12,10,2
2018,1300,1400,16,10,6
2018,1301,1400,9,10,-1
2018,1305,1400,7,10,-3
2018,1308,1400,12,10,2
2018,1314,1400,2,10,-8
2018,1326,1400,5,10,-5
2018,1328,1400,10,10,0
2018,1335,1400,16,10,6
2018,1344,1400,10,10,0
2018,1345,1400,2,10,-8
2018,1347,1400,16,10,6
2018,1348,1400,7,10,-3
2018,1355,1400,12,10,2
2018,1361,1400,11,10,1
2018,1371,1400,8,10,-2
2018,1372,1400,14,10,4
2018,1382,1400,11,10,1
2018,1393,1400,11,10,1
2018,1395,1400,6,10,-4
2018,1397,1400,3,10,-7
2018,1104,1401,9,7,2
2018,1112,1401,4,7,-3
2018,1113,1401,11,7,4
2018,1116,1401,7,7,0
2018,1120,1401,4,7,-3
2018,1137,1401,14,7,7
2018,1138,1401,13,7,6
2018,1139,1401,10,7,3
2018,1153,1401,2,7,-5
2018,1155,1401,5,7,-2
2018,1158,1401,13,7,6
2018,1166,1401,8,7,1
2018,1168,1401,15,7,8
2018,1172,1401,12,7,5
2018,1181,1401,2,7,-5
2018,1196,1401,6,7,-1
2018,1199,1401,9,7,2
2018,1209,1401,15,7,8
2018,1211,1401,4,7,-3
2018,1222,1401,6,7,-1
2018,1233,1401,15,7,8
2018,1242,1401,1,7,-6
2018,1243,1401,9,7,2
2018,1246,1401,5,7,-2
2018,1252,1401,15,7,8
2018,1254,1401,16,7,9
2018,1260,1401,11,7,4
2018,1267,1401,13,7,6
2018,1274,1401,6,7,-1
2018,1276,1401,3,7,-4
2018,1277,1401,3,7,-4
2018,1281,1401,8,7,1
2018,1285,1401,14,7,7
2018,1293,1401,12,7,5
2018,1300,1401,16,7,9
2018,1301,1401,9,7,2
2018,1305,1401,7,7,0
2018,1308,1401,12,7,5
2018,1314,1401,2,7,-5
2018,1326,1401,5,7,-2
2018,1328,1401,10,7,3
2018,1335,1401,16,7,9
2018,1344,1401,10,7,3
2018,1345,1401,2,7,-5
2018,1347,1401,16,7,9
2018,1348,1401,7,7,0
2018,1355,1401,12,7,5
2018,1361,1401,11,7,4
2018,1371,1401,8,7,1
2018,1372,1401,14,7,7
2018,1382,1401,11,7,4
2018,1393,1401,11,7,4
2018,1395,1401,6,7,-1
2018,1397,1401,3,7,-4
2018,1400,1401,10,7,3
2018,1104,1403,9,3,6
2018,1112,1403,4,3,1
2018,1113,1403,11,3,8
2018,1116,1403,7,3,4
2018,1120,1403,4,3,1
2018,1137,1403,14,3,11
2018,1138,1403,13,3,10
2018,1139,1403,10,3,7
2018,1153,1403,2,3,-1
2018,1155,1403,5,3,2
2018,1158,1403,13,3,10
2018,1166,1403,8,3,5
2018,1168,1403,15,3,12
2018,1172,1403,12,3,9
2018,1181,1403,2,3,-1
2018,1196,1403,6,3,3
2018,1199,1403,9,3,6
2018,1209,1403,15,3,12
2018,1211,1403,4,3,1
2018,1222,1403,6,3,3
2018,1233,1403,15,3,12
2018,1242,1403,1,3,-2
2018,1243,1403,9,3,6
2018,1246,1403,5,3,2
2018,1252,1403,15,3,12
2018,1254,1403,16,3,13
2018,1260,1403,11,3,8
2018,1267,1403,13,3,10
2018,1274,1403,6,3,3
2018,1276,1403,3,3,0
2018,1277,1403,3,3,0
2018,1281,1403,8,3,5
2018,1285,1403,14,3,11
2018,1293,1403,12,3,9
2018,1300,1403,16,3,13
2018,1301,1403,9,3,6
2018,1305,1403,7,3,4
2018,1308,1403,12,3,9
2018,1314,1403,2,3,-1
2018,1326,1403,5,3,2
2018,1328,1403,10,3,7
2018,1335,1403,16,3,13
2018,1344,1403,10,3,7
2018,1345,1403,2,3,-1
2018,1347,1403,16,3,13
2018,1348,1403,7,3,4
2018,1355,1403,12,3,9
2018,1361,1403,11,3,8
2018,1371,1403,8,3,5
2018,1372,1403,14,3,11
2018,1382,1403,11,3,8
2018,1393,1403,11,3,8
2018,1395,1403,6,3,3
2018,1397,1403,3,3,0
2018,1400,1403,10,3,7
2018,1401,1403,7,3,4
2018,1104,1411,9,16,-7
2018,1112,1411,4,16,-12
2018,1113,1411,11,16,-5
2018,1116,1411,7,16,-9
2018,1120,1411,4,16,-12
2018,1137,1411,14,16,-2
2018,1138,1411,13,16,-3
2018,1139,1411,10,16,-6
2018,1153,1411,2,16,-14
2018,1155,1411,5,16,-11
2018,1158,1411,13,16,-3
2018,1166,1411,8,16,-8
2018,1168,1411,15,16,-1
2018,1172,1411,12,16,-4
2018,1181,1411,2,16,-14
2018,1196,1411,6,16,-10
2018,1199,1411,9,16,-7
2018,1209,1411,15,16,-1
2018,1211,1411,4,16,-12
2018,1222,1411,6,16,-10
2018,1233,1411,15,16,-1
2018,1242,1411,1,16,-15
2018,1243,1411,9,16,-7
2018,1246,1411,5,16,-11
2018,1252,1411,15,16,-1
2018,1254,1411,16,16,0
2018,1260,1411,11,16,-5
2018,1267,1411,13,16,-3
2018,1274,1411,6,16,-10
2018,1276,1411,3,16,-13
2018,1277,1411,3,16,-13
2018,1281,1411,8,16,-8
2018,1285,1411,14,16,-2
2018,1293,1411,12,16,-4
2018,1300,1411,16,16,0
2018,1301,1411,9,16,-7
2018,1305,1411,7,16,-9
2018,1308,1411,12,16,-4
2018,1314,1411,2,16,-14
2018,1326,1411,5,16,-11
2018,1328,1411,10,16,-6
2018,1335,1411,16,16,0
2018,1344,1411,10,16,-6
2018,1345,1411,2,16,-14
2018,1347,1411,16,16,0
2018,1348,1411,7,16,-9
2018,1355,1411,12,16,-4
2018,1361,1411,11,16,-5
2018,1371,1411,8,16,-8
2018,1372,1411,14,16,-2
2018,1382,1411,11,16,-5
2018,1393,1411,11,16,-5
2018,1395,1411,6,16,-10
2018,1397,1411,3,16,-13
2018,1400,1411,10,16,-6
2018,1401,1411,7,16,-9
2018,1403,1411,3,16,-13
2018,1104,1417,9,11,-2
2018,1112,1417,4,11,-7
2018,1113,1417,11,11,0
2018,1116,1417,7,11,-4
2018,1120,1417,4,11,-7
2018,1137,1417,14,11,3
2018,1138,1417,13,11,2
2018,1139,1417,10,11,-1
2018,1153,1417,2,11,-9
2018,1155,1417,5,11,-6
2018,1158,1417,13,11,2
2018,1166,1417,8,11,-3
2018,1168,1417,15,11,4
2018,1172,1417,12,11,1
2018,1181,1417,2,11,-9
2018,1196,1417,6,11,-5
2018,1199,1417,9,11,-2
2018,1209,1417,15,11,4
2018,1211,1417,4,11,-7
2018,1222,1417,6,11,-5
2018,1233,1417,15,11,4
2018,1242,1417,1,11,-10
2018,1243,1417,9,11,-2
2018,1246,1417,5,11,-6
2018,1252,1417,15,11,4
2018,1254,1417,16,11,5
2018,1260,1417,11,11,0
2018,1267,1417,13,11,2
2018,1274,1417,6,11,-5
2018,1276,1417,3,11,-8
2018,1277,1417,3,11,-8
2018,1281,1417,8,11,-3
2018,1285,1417,14,11,3
2018,1293,1417,12,11,1
2018,1300,1417,16,11,5
2018,1301,1417,9,11,-2
2018,1305,1417,7,11,-4
2018,1308,1417,12,11,1
2018,1314,1417,2,11,-9
2018,1326,1417,5,11,-6
2018,1328,1417,10,11,-1
2018,1335,1417,16,11,5
2018,1344,1417,10,11,-1
2018,1345,1417,2,11,-9
2018,1347,1417,16,11,5
2018,1348,1417,7,11,-4
2018,1355,1417,12,11,1
2018,1361,1417,11,11,0
2018,1371,1417,8,11,-3
2018,1372,1417,14,11,3
2018,1382,1417,11,11,0
2018,1393,1417,11,11,0
2018,1395,1417,6,11,-5
2018,1397,1417,3,11,-8
2018,1400,1417,10,11,-1
2018,1401,1417,7,11,-4
2018,1403,1417,3,11,-8
2018,1411,1417,16,11,5
2018,1104,1420,9,16,-7
2018,1112,1420,4,16,-12
2018,1113,1420,11,16,-5
2018,1116,1420,7,16,-9
2018,1120,1420,4,16,-12
2018,1137,1420,14,16,-2
2018,1138,1420,13,16,-3
2018,1139,1420,10,16,-6
2018,1153,1420,2,16,-14
2018,1155,1420,5,16,-11
2018,1158,1420,13,16,-3
2018,1166,1420,8,16,-8
2018,1168,1420,15,16,-1
2018,1172,1420,12,16,-4
2018,1181,1420,2,16,-14
2018,1196,1420,6,16,-10
2018,1199,1420,9,16,-7
2018,1209,1420,15,16,-1
2018,1211,1420,4,16,-12
2018,1222,1420,6,16,-10
2018,1233,1420,15,16,-1
2018,1242,1420,1,16,-15
2018,1243,1420,9,16,-7
2018,1246,1420,5,16,-11
2018,1252,1420,15,16,-1
2018,1254,1420,16,16,0
2018,1260,1420,11,16,-5
2018,1267,1420,13,16,-3
2018,1274,1420,6,16,-10
2018,1276,1420,3,16,-13
2018,1277,1420,3,16,-13
2018,1281,1420,8,16,-8
2018,1285,1420,14,16,-2
2018,1293,1420,12,16,-4
2018,1300,1420,16,16,0
2018,1301,1420,9,16,-7
2018,1305,1420,7,16,-9
2018,1308,1420,12,16,-4
2018,1314,1420,2,16,-14
2018,1326,1420,5,16,-11
2018,1328,1420,10,16,-6
2018,1335,1420,16,16,0
2018,1344,1420,10,16,-6
2018,1345,1420,2,16,-14
2018,1347,1420,16,16,0
2018,1348,1420,7,16,-9
2018,1355,1420,12,16,-4
2018,1361,1420,11,16,-5
2018,1371,1420,8,16,-8
2018,1372,1420,14,16,-2
2018,1382,1420,11,16,-5
2018,1393,1420,11,16,-5
2018,1395,1420,6,16,-10
2018,1397,1420,3,16,-13
2018,1400,1420,10,16,-6
2018,1401,1420,7,16,-9
2018,1403,1420,3,16,-13
2018,1411,1420,16,16,0
2018,1417,1420,11,16,-5
2018,1104,1422,9,13,-4
2018,1112,1422,4,13,-9
2018,1113,1422,11,13,-2
2018,1116,1422,7,13,-6
2018,1120,1422,4,13,-9
2018,1137,1422,14,13,1
2018,1138,1422,13,13,0
2018,1139,1422,10,13,-3
2018,1153,1422,2,13,-11
2018,1155,1422,5,13,-8
2018,1158,1422,13,13,0
2018,1166,1422,8,13,-5
2018,1168,1422,15,13,2
2018,1172,1422,12,13,-1
2018,1181,1422,2,13,-11
2018,1196,1422,6,13,-7
2018,1199,1422,9,13,-4
2018,1209,1422,15,13,2
2018,1211,1422,4,13,-9
2018,1222,1422,6,13,-7
2018,1233,1422,15,13,2
2018,1242,1422,1,13,-12
2018,1243,1422,9,13,-4
2018,1246,1422,5,13,-8
2018,1252,1422,15,13,2
2018,1254,1422,16,13,3
2018,1260,1422,11,13,-2
2018,1267,1422,13,13,0
2018,1274,1422,6,13,-7
2018,1276,1422,3,13,-10
2018,1277,1422,3,13,-10
2018,1281,1422,8,13,-5
2018,1285,1422,14,13,1
2018,1293,1422,12,13,-1
2018,1300,1422,16,13,3
2018,1301,1422,9,13,-4
2018,1305,1422,7,13,-6
2018,1308,1422,12,13,-1
2018,1314,1422,2,13,-11
2018,1326,1422,5,13,-8
2018,1328,1422,10,13,-3
2018,1335,1422,16,13,3
2018,1344,1422,10,13,-3
2018,1345,1422,2,13,-11
2018,1347,1422,16,13,3
2018,1348,1422,7,13,-6
2018,1355,1422,12,13,-1
2018,1361,1422,11,13,-2
2018,1371,1422,8,13,-5
2018,1372,1422,14,13,1
2018,1382,1422,11,13,-2
2018,1393,1422,11,13,-2
2018,1395,1422,6,13,-7
2018,1397,1422,3,13,-10
2018,1400,1422,10,13,-3
2018,1401,1422,7,13,-6
2018,1403,1422,3,13,-10
2018,1411,1422,16,13,3
2018,1417,1422,11,13,-2
2018,1420,1422,16,13,3
2018,1104,1437,9,1,8
2018,1112,1437,4,1,3
2018,1113,1437,11,1,10
2018,1116,1437,7,1,6
2018,1120,1437,4,1,3
2018,1137,1437,14,1,13
2018,1138,1437,13,1,12
2018,1139,1437,10,1,9
2018,1153,1437,2,1,1
2018,1155,1437,5,1,4
2018,1158,1437,13,1,12
2018,1166,1437,8,1,7
2018,1168,1437,15,1,14
2018,1172,1437,12,1,11
2018,1181,1437,2,1,1
2018,1196,1437,6,1,5
2018,1199,1437,9,1,8
2018,1209,1437,15,1,14
2018,1211,1437,4,1,3
2018,1222,1437,6,1,5
2018,1233,1437,15,1,14
2018,1242,1437,1,1,0
2018,1243,1437,9,1,8
2018,1246,1437,5,1,4
2018,1252,1437,15,1,14
2018,1254,1437,16,1,15
2018,1260,1437,11,1,10
2018,1267,1437,13,1,12
2018,1274,1437,6,1,5
2018,1276,1437,3,1,2
2018,1277,1437,3,1,2
2018,1281,1437,8,1,7
2018,1285,1437,14,1,13
2018,1293,1437,12,1,11
2018,1300,1437,16,1,15
2018,1301,1437,9,1,8
2018,1305,1437,7,1,6
2018,1308,1437,12,1,11
2018,1314,1437,2,1,1
2018,1326,1437,5,1,4
2018,1328,1437,10,1,9
2018,1335,1437,16,1,15
2018,1344,1437,10,1,9
2018,1345,1437,2,1,1
2018,1347,1437,16,1,15
2018,1348,1437,7,1,6
2018,1355,1437,12,1,11
2018,1361,1437,11,1,10
2018,1371,1437,8,1,7
2018,1372,1437,14,1,13
2018,1382,1437,11,1,10
2018,1393,1437,11,1,10
2018,1395,1437,6,1,5
2018,1397,1437,3,1,2
2018,1400,1437,10,1,9
2018,1401,1437,7,1,6
2018,1403,1437,3,1,2
2018,1411,1437,16,1,15
2018,1417,1437,11,1,10
2018,1420,1437,16,1,15
2018,1422,1437,13,1,12
2018,1104,1438,9,1,8
2018,1112,1438,4,1,3
2018,1113,1438,11,1,10
2018,1116,1438,7,1,6
2018,1120,1438,4,1,3
2018,1137,1438,14,1,13
2018,1138,1438,13,1,12
2018,1139,1438,10,1,9
2018,1153,1438,2,1,1
2018,1155,1438,5,1,4
2018,1158,1438,13,1,12
2018,1166,1438,8,1,7
2018,1168,1438,15,1,14
2018,1172,1438,12,1,11
2018,1181,1438,2,1,1
2018,1196,1438,6,1,5
2018,1199,1438,9,1,8
2018,1209,1438,15,1,14
2018,1211,1438,4,1,3
2018,1222,1438,6,1,5
2018,1233,1438,15,1,14
2018,1242,1438,1,1,0
2018,1243,1438,9,1,8
2018,1246,1438,5,1,4
2018,1252,1438,15,1,14
2018,1254,1438,16,1,15
2018,1260,1438,11,1,10
2018,1267,1438,13,1,12
2018,1274,1438,6,1,5
2018,1276,1438,3,1,2
2018,1277,1438,3,1,2
2018,1281,1438,8,1,7
2018,1285,1438,14,1,13
2018,1293,1438,12,1,11
2018,1300,1438,16,1,15
2018,1301,1438,9,1,8
2018,1305,1438,7,1,6
2018,1308,1438,12,1,11
2018,1314,1438,2,1,1
2018,1326,1438,5,1,4
2018,1328,1438,10,1,9
2018,1335,1438,16,1,15
2018,1344,1438,10,1,9
2018,1345,1438,2,1,1
2018,1347,1438,16,1,15
2018,1348,1438,7,1,6
2018,1355,1438,12,1,11
2018,1361,1438,11,1,10
2018,1371,1438,8,1,7
2018,1372,1438,14,1,13
2018,1382,1438,11,1,10
2018,1393,1438,11,1,10
2018,1395,1438,6,1,5
2018,1397,1438,3,1,2
2018,1400,1438,10,1,9
2018,1401,1438,7,1,6
2018,1403,1438,3,1,2
2018,1411,1438,16,1,15
2018,1417,1438,11,1,10
2018,1420,1438,16,1,15
2018,1422,1438,13,1,12
2018,1437,1438,1,1,0
2018,1104,1439,9,8,1
2018,1112,1439,4,8,-4
2018,1113,1439,11,8,3
2018,1116,1439,7,8,-1
2018,1120,1439,4,8,-4
2018,1137,1439,14,8,6
2018,1138,1439,13,8,5
2018,1139,1439,10,8,2
2018,1153,1439,2,8,-6
2018,1155,1439,5,8,-3
2018,1158,1439,13,8,5
2018,1166,1439,8,8,0
2018,1168,1439,15,8,7
2018,1172,1439,12,8,4
2018,1181,1439,2,8,-6
2018,1196,1439,6,8,-2
2018,1199,1439,9,8,1
2018,1209,1439,15,8,7
2018,1211,1439,4,8,-4
2018,1222,1439,6,8,-2
2018,1233,1439,15,8,7
2018,1242,1439,1,8,-7
2018,1243,1439,9,8,1
2018,1246,1439,5,8,-3
2018,1252,1439,15,8,7
2018,1254,1439,16,8,8
2018,1260,1439,11,8,3
2018,1267,1439,13,8,5
2018,1274,1439,6,8,-2
2018,1276,1439,3,8,-5
2018,1277,1439,3,8,-5
2018,1281,1439,8,8,0
2018,1285,1439,14,8,6
2018,1293,1439,12,8,4
2018,1300,1439,16,8,8
2018,1301,1439,9,8,1
2018,1305,1439,7,8,-1
2018,1308,1439,12,8,4
2018,1314,1439,2,8,-6
2018,1326,1439,5,8,-3
2018,1328,1439,10,8,2
2018,1335,1439,16,8,8
2018,1344,1439,10,8,2
2018,1345,1439,2,8,-6
2018,1347,1439,16,8,8
2018,1348,1439,7,8,-1
2018,1355,1439,12,8,4
2018,1361,1439,11,8,3
2018,1371,1439,8,8,0
2018,1372,1439,14,8,6
2018,1382,1439,11,8,3
2018,1393,1439,11,8,3
2018,1395,1439,6,8,-2
2018,1397,1439,3,8,-5
2018,1400,1439,10,8,2
2018,1401,1439,7,8,-1
2018,1403,1439,3,8,-5
2018,1411,1439,16,8,8
2018,1417,1439,11,8,3
2018,1420,1439,16,8,8
2018,1422,1439,13,8,5
2018,1437,1439,1,8,-7
2018,1438,1439,1,8,-7
2018,1104,1452,9,5,4
2018,1112,1452,4,5,-1
2018,1113,1452,11,5,6
2018,1116,1452,7,5,2
2018,1120,1452,4,5,-1
2018,1137,1452,14,5,9
2018,1138,1452,13,5,8
2018,1139,1452,10,5,5
2018,1153,1452,2,5,-3
2018,1155,1452,5,5,0
2018,1158,1452,13,5,8
2018,1166,1452,8,5,3
2018,1168,1452,15,5,10
2018,1172,1452,12,5,7
2018,1181,1452,2,5,-3
2018,1196,1452,6,5,1
2018,1199,1452,9,5,4
2018,1209,1452,15,5,10
2018,1211,1452,4,5,-1
2018,1222,1452,6,5,1
2018,1233,1452,15,5,10
2018,1242,1452,1,5,-4
2018,1243,1452,9,5,4
2018,1246,1452,5,5,0
2018,1252,1452,15,5,10
2018,1254,1452,16,5,11
2018,1260,1452,11,5,6
2018,1267,1452,13,5,8
2018,1274,1452,6,5,1
2018,1276,1452,3,5,-2
2018,1277,1452,3,5,-2
2018,1281,1452,8,5,3
2018,1285,1452,14,5,9
2018,1293,1452,12,5,7
2018,1300,1452,16,5,11
2018,1301,1452,9,5,4
2018,1305,1452,7,5,2
2018,1308,1452,12,5,7
2018,1314,1452,2,5,-3
2018,1326,1452,5,5,0
2018,1328,1452,10,5,5
2018,1335,1452,16,5,11
2018,1344,1452,10,5,5
2018,1345,1452,2,5,-3
2018,1347,1452,16,5,11
2018,1348,1452,7,5,2
2018,1355,1452,12,5,7
2018,1361,1452,11,5,6
2018,1371,1452,8,5,3
2018,1372,1452,14,5,9
2018,1382,1452,11,5,6
2018,1393,1452,11,5,6
2018,1395,1452,6,5,1
2018,1397,1452,3,5,-2
2018,1400,1452,10,5,5
2018,1401,1452,7,5,2
2018,1403,1452,3,5,-2
2018,1411,1452,16,5,11
2018,1417,1452,11,5,6
2018,1420,1452,16,5,11
2018,1422,1452,13,5,8
2018,1437,1452,1,5,-4
2018,1438,1452,1,5,-4
2018,1439,1452,8,5,3
2018,1104,1455,9,4,5
2018,1112,1455,4,4,0
2018,1113,1455,11,4,7
2018,1116,1455,7,4,3
2018,1120,1455,4,4,0
2018,1137,1455,14,4,10
2018,1138,1455,13,4,9
2018,1139,1455,10,4,6
2018,1153,1455,2,4,-2
2018,1155,1455,5,4,1
2018,1158,1455,13,4,9
2018,1166,1455,8,4,4
2018,1168,1455,15,4,11
2018,1172,1455,12,4,8
2018,1181,1455,2,4,-2
2018,1196,1455,6,4,2
2018,1199,1455,9,4,5
2018,1209,1455,15,4,11
2018,1211,1455,4,4,0
2018,1222,1455,6,4,2
2018,1233,1455,15,4,11
2018,1242,1455,1,4,-3
2018,1243,1455,9,4,5
2018,1246,1455,5,4,1
2018,1252,1455,15,4,11
2018,1254,1455,16,4,12
2018,1260,1455,11,4,7
2018,1267,1455,13,4,9
2018,1274,1455,6,4,2
2018,1276,1455,3,4,-1
2018,1277,1455,3,4,-1
2018,1281,1455,8,4,4
2018,1285,1455,14,4,10
2018,1293,1455,12,4,8
2018,1300,1455,16,4,12
2018,1301,1455,9,4,5
2018,1305,1455,7,4,3
2018,1308,1455,12,4,8
2018,1314,1455,2,4,-2
2018,1326,1455,5,4,1
2018,1328,1455,10,4,6
2018,1335,1455,16,4,12
2018,1344,1455,10,4,6
2018,1345,1455,2,4,-2
2018,1347,1455,16,4,12
2018,1348,1455,7,4,3
2018,1355,1455,12,4,8
2018,1361,1455,11,4,7
2018,1371,1455,8,4,4
2018,1372,1455,14,4,10
2018,1382,1455,11,4,7
2018,1393,1455,11,4,7
2018,1395,1455,6,4,2
2018,1397,1455,3,4,-1
2018,1400,1455,10,4,6
2018,1401,1455,7,4,3
2018,1403,1455,3,4,-1
2018,1411,1455,16,4,12
2018,1417,1455,11,4,7
2018,1420,1455,16,4,12
2018,1422,1455,13,4,9
2018,1437,1455,1,4,-3
2018,1438,1455,1,4,-3
2018,1439,1455,8,4,4
2018,1452,1455,5,4,1
2018,1104,1460,9,14,-5
2018,1112,1460,4,14,-10
2018,1113,1460,11,14,-3
2018,1116,1460,7,14,-7
2018,1120,1460,4,14,-10
2018,1137,1460,14,14,0
2018,1138,1460,13,14,-1
2018,1139,1460,10,14,-4
2018,1153,1460,2,14,-12
2018,1155,1460,5,14,-9
2018,1158,1460,13,14,-1
2018,1166,1460,8,14,-6
2018,1168,1460,15,14,1
2018,1172,1460,12,14,-2
2018,1181,1460,2,14,-12
2018,1196,1460,6,14,-8
2018,1199,1460,9,14,-5
2018,1209,1460,15,14,1
2018,1211,1460,4,14,-10
2018,1222,1460,6,14,-8
2018,1233,1460,15,14,1
2018,1242,1460,1,14,-13
2018,1243,1460,9,14,-5
2018,1246,1460,5,14,-9
2018,1252,1460,15,14,1
2018,1254,1460,16,14,2
2018,1260,1460,11,14,-3
2018,1267,1460,13,14,-1
2018,1274,1460,6,14,-8
2018,1276,1460,3,14,-11
2018,1277,1460,3,14,-11
2018,1281,1460,8,14,-6
2018,1285,1460,14,14,0
2018,1293,1460,12,14,-2
2018,1300,1460,16,14,2
2018,1301,1460,9,14,-5
2018,1305,1460,7,14,-7
2018,1308,1460,12,14,-2
2018,1314,1460,2,14,-12
2018,1326,1460,5,14,-9
2018,1328,1460,10,14,-4
2018,1335,1460,16,14,2
2018,1344,1460,10,14,-4
2018,1345,1460,2,14,-12
2018,1347,1460,16,14,2
2018,1348,1460,7,14,-7
2018,1355,1460,12,14,-2
2018,1361,1460,11,14,-3
2018,1371,1460,8,14,-6
2018,1372,1460,14,14,0
2018,1382,1460,11,14,-3
2018,1393,1460,11,14,-3
2018,1395,1460,6,14,-8
2018,1397,1460,3,14,-11
2018,1400,1460,10,14,-4
2018,1401,1460,7,14,-7
2018,1403,1460,3,14,-11
2018,1411,1460,16,14,2
2018,1417,1460,11,14,-3
2018,1420,1460,16,14,2
2018,1422,1460,13,14,-1
2018,1437,1460,1,14,-13
2018,1438,1460,1,14,-13
2018,1439,1460,8,14,-6
2018,1452,1460,5,14,-9
2018,1455,1460,4,14,-10
2018,1104,1462,9,1,8
2018,1112,1462,4,1,3
2018,1113,1462,11,1,10
2018,1116,1462,7,1,6
2018,1120,1462,4,1,3
2018,1137,1462,14,1,13
2018,1138,1462,13,1,12
2018,1139,1462,10,1,9
2018,1153,1462,2,1,1
2018,1155,1462,5,1,4
2018,1158,1462,13,1,12
2018,1166,1462,8,1,7
2018,1168,1462,15,1,14
2018,1172,1462,12,1,11
2018,1181,1462,2,1,1
2018,1196,1462,6,1,5
2018,1199,1462,9,1,8
2018,1209,1462,15,1,14
2018,1211,1462,4,1,3
2018,1222,1462,6,1,5
2018,1233,1462,15,1,14
2018,1242,1462,1,1,0
2018,1243,1462,9,1,8
2018,1246,1462,5,1,4
2018,1252,1462,15,1,14
2018,1254,1462,16,1,15
2018,1260,1462,11,1,10
2018,1267,1462,13,1,12
2018,1274,1462,6,1,5
2018,1276,1462,3,1,2
2018,1277,1462,3,1,2
2018,1281,1462,8,1,7
2018,1285,1462,14,1,13
2018,1293,1462,12,1,11
2018,1300,1462,16,1,15
2018,1301,1462,9,1,8
2018,1305,1462,7,1,6
2018,1308,1462,12,1,11
2018,1314,1462,2,1,1
2018,1326,1462,5,1,4
2018,1328,1462,10,1,9
2018,1335,1462,16,1,15
2018,1344,1462,10,1,9
2018,1345,1462,2,1,1
2018,1347,1462,16,1,15
2018,1348,1462,7,1,6
2018,1355,1462,12,1,11
2018,1361,1462,11,1,10
2018,1371,1462,8,1,7
2018,1372,1462,14,1,13
2018,1382,1462,11,1,10
2018,1393,1462,11,1,10
2018,1395,1462,6,1,5
2018,1397,1462,3,1,2
2018,1400,1462,10,1,9
2018,1401,1462,7,1,6
2018,1403,1462,3,1,2
2018,1411,1462,16,1,15
2018,1417,1462,11,1,10
2018,1420,1462,16,1,15
2018,1422,1462,13,1,12
2018,1437,1462,1,1,0
2018,1438,1462,1,1,0
2018,1439,1462,8,1,7
2018,1452,1462,5,1,4
2018,1455,1462,4,1,3
2018,1460,1462,14,1,13
